budget,revenue,actor,director,runtime,genre,profit
7000,424760,Shane Carruth,Shane Carruth,79,Science Fiction,417760
8000,469947,Tom Cullen,Andrew Haigh,96,Drama,461947
10000,7000000,Jack Nance,David Lynch,89,Science Fiction,6990000
12000,6000000,Divine,John Waters,93,Comedy,5988000
15000,193355800,Katie Featherston,Oren Peli,86,Horror,193340800
17000,101236,Evan Glodell,Evan Glodell,106,Action,84236
25000,248000000,Heather Donahue,Daniel Myrick,81,Horror,247975000
27000,3151130,Brian O'Halloran,Kevin Smith,92,Comedy,3124130
30000,3045943,Megan Faccio,Henry Joost,87,Documentary,3015943
30000,617000,James Franco,Rob Epstein,84,Drama,587000
31192,10000,Robert Hill,Ben Wheatley,89,Drama,-21192
40000,1434436,Robert Evans,Nanette Burstein,93,Documentary,1394436
45202,225861,Cindy Baer,Kevin Macdonald,95,Documentary,180659
50000,249905,Anessa Ramsey,David Bruckner,103,Horror,199905
60000,3221152,Sean Gullette,Darren Aronofsky,84,Mystery,3161152
65000,28575078,Morgan Spurlock,Morgan Spurlock,100,Documentary,28510078
74050,176153,Asia Argento,Asia Argento,98,Drama,102103
79000,245000,Danny McBride,Jody Hill,85,Comedy,166000
85000,30859000,Allen Danziger,Tobe Hooper,83,Horror,30774000
100000,10178331,James Blackwell,Alex Kendrick,111,Drama,10078331
100000,95000,Ross Noble,Conor McMahon,86,Horror,-5000
100000,1776935,Brit Marling,Mike Cahill,92,Drama,1676935
100000,490475,Uma Thurman,Richard Linklater,86,Drama,390475
100000,444098,Amy Seimetz,Shane Carruth,96,Drama,344098
100000,42664410,Cassidy Gifford,Travis Cluff,87,Horror,42564410
125000,3200000,Mark Duplass,Lynn Shelton,90,Drama,3075000
130000,54667954,Blanchard Ryan,Chris Kentis,79,Drama,54537954
134005,1332231,Li Bingbing,Wayne Wang,104,History,1198226
160000,20710513,Glen Hansard,John Carney,85,Drama,20550513
169000,18564702,Rowan Atkinson,Niall Johnson,103,Comedy,18395702
200000,4505922,Jon Favreau,Doug Liman,94,Comedy,4305922
200000,17834867,Jared Harris,John Pogue,98,Horror,17634867
200000,2000000,Vincent Price,Roger Corman,80,Horror,1800000
220000,2040920,Carlos Gallardo,Robert Rodriguez,81,Action,1820920
230000,25000000,Martin Speer,Wes Craven,89,Horror,24770000
250000,3542353,Anton Yelchin,Drake Doremus,90,Drama,3292353
250000,12021272,Ben Affleck,Kevin Smith,113,Comedy,11771272
250000,154323,Eric Freeman,Lee Harry,88,Comedy,-95677
250000,4186931,Catherine Keener,Nicole Holofcener,91,Comedy,3936931
250000,56825,Lindsay Lohan,Paul Schrader,99,Thriller,-193175
250000,232732,Patton Oswalt,Robert D. Siegel,91,Comedy,-17268
250000,501818,Nicole de Boer,Vincenzo Natali,90,Thriller,251818
300000,11988469,Angus Scrimm,Don Coscarelli,89,Horror,11688469
300000,2750275,Tom Schilling,Jan Ole Gerster,88,Comedy,2450275
300000,70000000,Donald Pleasence,John Carpenter,91,Horror,69700000
318000,121179,Baya Rehaz,Clif Prowse,85,Horror,-196821
350000,29400000,Bruce Campbell,Sam Raimi,85,Horror,29050000
350000,3515061,Zana Briski,Zana Briski,85,Documentary,3165061
400000,100000000,Mel Gibson,George Miller,93,Adventure,99600000
400000,46118097,Jon Heder,Jared Hess,95,Comedy,45718097
400000,5028948,Graham Chapman,Terry Gilliam,91,Adventure,4628948
425000,10604986,Kate McNeil,Mark Rosman,91,Horror,10179986
441892,1030375,Salman Khan,David Dhawan,155,Comedy,588483
447524,771317,Jack Black,Andrew Mogel,101,Drama,323793
450000,973525,Helena Bonham Carter,Hans Canosa,84,Drama,523525
450000,2049595,Tori Spelling,Jim Fall,89,Comedy,1599595
475000,3919254,Joseph Gordon-Levitt,Rian Johnson,110,Drama,3444254
500000,10166459,Jean-Claude Van Damme,Albert Pyun,86,Action,9666459
500000,33456317,Kirk Cameron,Alex Kendrick,122,Drama,32956317
500000,2500000,Anne Bancroft,Arthur Penn,106,Drama,2000000
500000,171760,Neil Maskell,Ben Wheatley,95,Horror,-328240
500000,15000000,Josh Hartnett,Brian Horiuchi,139,Science Fiction,14500000
500000,1000000,Nicholas Hope,Daniel Krige,93,Thriller,500000
500000,4242978,Whitney Able,Gareth Edwards,94,Drama,3742978
500000,603943,Rory Culkin,Jacob Aaron Estes,90,Crime,103943
500000,376597,Mary Elizabeth Winstead,James Ponsoldt,85,Drama,-123403
500000,3779620,Dorian Corey,Jennie Livingston,71,Documentary,3279620
500000,17000000,William Shatner,John 'Bud' Cardos,97,Horror,16500000
500000,150277,Angela Bettis,Lucky McKee,93,Drama,-349723
500000,3000000,Harvey Keitel,Martin Scorsese,110,Drama,2500000
500000,220151,Jonathon Trent,Q. Allan Brocka,88,Drama,-279849
500000,98017,Thomas F. Duffy,Quentin Dupieux,85,Comedy,-401983
500000,1000549,John Lennon,Richard Lester,88,Comedy,500549
500000,745327,Michael Carbonaro,Todd Stephens,92,Comedy,245327
500000,1148752,Steve Buscemi,Tom DiCillo,89,Drama,648752
500000,8679814,Peter Dinklage,Tom McCarthy,88,Drama,8179814
550000,59754601,Betsy Palmer,Sean S. Cunningham,95,Horror,59204601
600000,4000000,John Simm,Justin Kerrigan,99,Comedy,3400000
600000,185898,Ren√©e Zellweger,Kim Henkel,95,Comedy,-414102
600000,7087452,Lily Tomlin,Paul Weitz,78,Drama,6487452
645180,14743391,Daniel Day-Lewis,Jim Sheridan,103,Drama,14098211
650000,55000000,David Emge,George A. Romero,127,Horror,54350000
650000,33245,Danielle Harris,Jim Mickle,98,Drama,-616755
700000,31576,Ellen Page,Bruce McDonald,77,Drama,-668424
700000,1667192,Paul Dano,Michael Cuesta,97,Drama,967192
700000,17986781,Shameik Moore,Rick Famuyiwa,103,Crime,17286781
700000,7830611,William Gates,Steve James,171,Documentary,7130611
725000,10600000,Clint Eastwood,Clint Eastwood,102,Crime,9875000
750000,4007792,Aubrey Plaza,Colin Trevorrow,85,Comedy,3257792
750000,78396,Sara Paxton,Ti West,102,Horror,-671604
777000,115000000,Richard Dreyfuss,George Lucas,110,Comedy,114223000
777000,2437000,Robert Duvall,George Lucas,86,Drama,1660000
786675,861789,Michael Caton,Rob Sitch,85,Drama,75114
800000,14000000,Peter Horton,Fritz Kiersch,93,Drama,13200000
800000,867714,Gemma Arterton,J Blakeson,100,Crime,67714
806948,32000000,Anthony Perkins,Alfred Hitchcock,109,Drama,31193052
810000,1258000,Richard Chamberlain,Peter Weir,106,Drama,448000
818418,4851244,Stefano Accorsi,Michele Placido,152,Drama,4032826
850000,819939,Steve Sandvoss,C. Jay Cox,107,Drama,-30061
850000,1243961,Ari Graynor,Jamie Travis,85,Comedy,393961
850000,90000000,Bruce Lee,Robert Clouse,99,Crime,89150000
860000,2451545,Gordon Warnecke,Stephen Frears,97,Drama,1591545
900000,6980986,Terence Knox,David Price,92,Horror,6080986
900000,381420,Elisha Cuthbert,Jamie Babbit,96,Drama,-518580
900000,8556940,Warwick Davis,Mark Jones,92,Comedy,7656940
900000,2023414,Jeffrey Combs,Stuart Gordon,86,Science Fiction,1123414
930000,30905,Krysten Ritter,Kat Coiro,100,Comedy,-899095
950000,7022209,Patrick Wilson,David Slade,103,Drama,6072209
950000,814666,Cliff Robertson,Ralph Nelson,103,Drama,-135334
967686,4270000,Riz Ahmed,Chris Morris,101,Comedy,3302314
994000,165000,Aml Ameen,Menhaj Huda,89,Drama,-829000
1000000,2554476,Christopher Walken,Abel Ferrara,103,Thriller,1554476
1000000,2019469,Harvey Keitel,Abel Ferrara,96,Crime,1019469
1000000,274661,Brian Keith Allen,Alex Gibney,106,Documentary,-725339
1000000,34522221,Alex Kendrick,Alex Kendrick,129,Drama,33522221
1000000,395000,Sheila Vand,Ana Lily Amirpour,99,Horror,-605000
1000000,6933459,Kuei Ya-Lei,Ang Lee,109,Comedy,5933459
1000000,9138338,John Hawkes,Ben Lewin,98,Drama,8138338
1000000,24475416,Billy Bob Thornton,Billy Bob Thornton,135,Drama,23475416
1000000,10013424,Jennifer Westfeldt,Charles Herman-Wurmfeld,97,Comedy,9013424
1000000,1678874,Martin Sheen,Chris Paine,92,Documentary,678874
1000000,14564027,Andrew Robinson,Clive Barker,94,Horror,13564027
1000000,46243000,Al Gore,Davis Guggenheim,100,Documentary,45243000
1000000,12355734,Ryan Gosling,Derek Cianfrance,112,Drama,11355734
1000000,13350369,Felicity Huffman,Duncan Tucker,103,Drama,12350369
1000000,1744858,Ben Weber,Greg Berlanti,94,Comedy,744858
1000000,27762648,John Jarratt,Greg McLean,99,Horror,26762648
1000000,7202,Michael Rapaport,Hal Haberman,81,Drama,-992798
1000000,10047674,Julian Morris,Jeff Wadlow,90,Horror,9047674
1000000,17985893,Patrick Macnee,Joe Dante,91,Drama,16985893
1000000,21378361,Adrienne Barbeau,John Carpenter,89,Horror,20378361
1000000,51525171,Emilio Estevez,John Hughes,97,Comedy,50525171
1000000,2000000,Warren Oates,John Milius,107,Action,1000000
1000000,2963902,Lake Bell,Lake Bell,93,Comedy,1963902
1000000,9318,Rose Leslie,Leigh Janiak,87,Horror,-990682
1000000,62882090,Shelley Hennig,Levan Gabriadze,82,Horror,61882090
1000000,35000000,Peter Liapis,Luca Bercovici,81,Comedy,34000000
1000000,3713768,John Hurt,Martin Rosen,88,Adventure,2713768
1000000,14444999,Sally Field,Michael Showalter,95,Comedy,13444999
1000000,332323,Kieran O'Brien,Michael Winterbottom,66,Drama,-667677
1000000,1296971,Michael Cera,Nicholas Jasenovec,88,Comedy,296971
1000000,14796236,Leslie Nielsen,Paul Lynch,92,Horror,13796236
1000000,26501323,Helen McCrory,Tom Harper,90,Thriller,25501323
1000000,78868508,Nick Nolte,Walter Hill,96,Thriller,77868508
1000000,101758490,Fernanda Andrade,William Brent Bell,83,Thriller,100758490
1052753,466088,Piolo Pascual,Erik Matti,120,Action,-586665
1100000,5450815,Noah Hathaway,John Carl Buechler,82,Fantasy,4350815
1100000,117235147,Sylvester Stallone,John G. Avildsen,119,Drama,116135147
1100000,631221,Kevin Gage,John Pieplow,86,Horror,-468779
1100000,59600000,Sean Connery,Terence Young,110,Adventure,58500000
1200000,2861020,Scott Elrod,David Boyd,114,Drama,1661020
1200000,103911669,Cary Elwes,James Wan,103,Horror,102711669
1200000,112892319,Tim Curry,Jim Sharman,100,Comedy,111692319
1200000,71215869,Bob Newhart,John Lounsbery,78,Fantasy,70015869
1200000,4978922,David Byrne,Jonathan Demme,88,Documentary,3778922
1200000,3109904,Cathy Podewell,Kevin Tenney,90,Horror,1909904
1200000,14661007,Harvey Keitel,Quentin Tarantino,99,Crime,13461007
1200000,9000000,Bob Holt,Ralph Bakshi,80,Animation,7800000
1200000,760883,Randy Norton,Ralph Bakshi,81,Animation,-439117
1250000,3412497,John Heard,Douglas Cheek,88,Horror,2162497
1250000,21722776,Amy Steel,Steve Miner,87,Horror,20472776
1300000,447741,James Ransone,Larry Clark,97,Drama,-852259
1300000,28262574,Robert De Niro,Martin Scorsese,113,Crime,26962574
1300000,29133000,Timothy Bottoms,Peter Bogdanovich,118,Drama,27833000
1300000,354704,Viggo Mortensen,Renny Harlin,102,Crime,-945296
1300000,72266306,Barry Newman,Richard C. Sarafian,99,Action,70966306
1350000,3897569,Jason Flemyng,Guy Ritchie,105,Comedy,2547569
1500000,2300000,Harry Dean Stanton,Alex Cox,92,Comedy,800000
1500000,373967,Peter Mullan,Brad Anderson,100,Horror,-1126033
1500000,173066,Bruce Campbell,Bruce Campbell,86,Comedy,-1326934
1500000,870751,Chris Stafford,David Moreton,99,Comedy,-629249
1500000,56000,Deborra-Lee Furness,Dean O'Flaherty,97,Drama,-1444000
1500000,30553394,Rider Strong,Eli Roth,93,Horror,29053394
1500000,416925,Ryan Gosling,Henry Bean,98,Drama,-1083075
1500000,97009150,Patrick Wilson,James Wan,103,Horror,95509150
1500000,7412216,Leo Fitzpatrick,Larry Clark,91,Drama,5912216
1500000,3566225,Aubrey Plaza,Maggie Carey,104,Comedy,2066225
1500000,14697005,Jean-Claude Van Damme,Mark DiSalle,97,Action,13197005
1500000,11806119,Jean-Claude Van Damme,Newt Arnold,92,Action,10306119
1500000,11098131,Jeff Daniels,Noah Baumbach,81,Comedy,9598131
1500000,712294,Daniel Day-Lewis,Rebecca Miller,111,Drama,-787706
1500000,5728953,Dylan McDermott,Richard Stanley,93,Horror,4228953
1500000,1165882,Sheri Moon Zombie,Rob Zombie,101,Horror,-334118
1500000,418961,Eric Stoltz,Roger Avary,96,Action,-1081039
1500000,2375097,Vincent Gallo,Vincent Gallo,110,Romance,875097
1549000,7096000,Jay Chou,Andrew Lau,107,Action,5547000
1600000,4420000,Gene Hackman,Francis Ford Coppola,113,Crime,2820000
1700000,8844595,Roddy McDowall,J. Lee Thompson,93,Action,7144595
1700000,1943649,Steve Zahn,Mark Illsley,98,Comedy,243649
1700000,1007962,Sasha Grey,Steven Soderbergh,77,Comedy,-692038
1746964,2181987,Harry Dean Stanton,Wim Wenders,147,Drama,435023
1750000,100000,Stacy Keach,Richard Franklin,101,Thriller,-1650000
1800000,21107746,Quvenzhan√© Wallis,Benh Zeitlin,93,Drama,19307746
1800000,33800000,Sissy Spacek,Brian De Palma,98,Horror,32000000
1800000,67738090,Ashley Bell,Daniel Stamm,87,Horror,65938090
1800000,9700000,Roddy McDowall,J. Lee Thompson,88,Action,7900000
1800000,46665856,Al Pacino,Sidney Lumet,125,Crime,44865856
1800000,9440272,Peter Sellers,Stanley Kubrick,95,Drama,7640272
1800000,31623833,Patrick Dempsey,Steve Rash,94,Drama,29823833
1800000,6800000,Clint Eastwood,Ted Post,114,Western,5000000
1800000,25504513,John Saxon,Wes Craven,91,Horror,23704513
1800000,41158757,Gene Hackman,William Friedkin,104,Action,39358757
1880006,26713187,Goldie Hawn,Garry Marshall,106,Comedy,24833181
1900000,4790926,Chris Makepeace,Richard Wenk,93,Comedy,2890926
1987650,19152480,Ryan Reynolds,Rodrigo Cort√©s,94,Drama,17164830
2000000,22179430,Keri Russell,Adrienne Shelly,108,Comedy,20179430
2000000,7900000,Barbara Harris,Alfred Hitchcock,121,Comedy,5900000
2000000,7306,Jon Hamm,Anders Anderson,97,Crime,-1992694
2000000,38135878,Konstantin Khabenskiy,Andrey Kravchuk,123,Action,36135878
2000000,11125849,Ari Folman,Ari Folman,90,Drama,9125849
2000000,54207,Melinda Clarke,Brian Yuzna,97,Horror,-1945793
2000000,4601043,Evan Rachel Wood,Catherine Hardwicke,100,Drama,2601043
2000000,1431623,Campbell Scott,Charles Ferguson,102,Documentary,-568377
2000000,7871522,Matt Damon,Charles Ferguson,109,Documentary,5871522
2000000,13101672,Elizabeth Olsen,Chris Kentis,85,Horror,11101672
2000000,5967038,Christian Bale,David Ayer,120,Crime,3967038
2000000,14400000,Kristen Bell,David Palmer,100,Action,12400000
2000000,13500000,Maika Monroe,David Robert Mitchell,100,Thriller,11500000
2000000,13831503,Jennifer Lawrence,Debra Granik,100,Drama,11831503
2000000,653621,Dennis Hopper,Fenton Bailey,92,Documentary,-1346379
2000000,5364858,Michelle Morgan,George A. Romero,95,Horror,3364858
2000000,24600832,Mel Gibson,George Miller,95,Adventure,22600832
2000000,6676471,Essie Davis,Jennifer Kent,93,Drama,4676471
2000000,2801508,Kate Mara,Jerry Jameson,97,Crime,801508
2000000,11000000,Richard Thomas,Jimmy T. Murakami,104,Science Fiction,9000000
2000000,46122355,Jon Voight,John Boorman,109,Drama,44122355
2000000,5179037,Sook-Yin Lee,John Cameron Mitchell,101,Romance,3179037
2000000,5048693,Guy Pearce,John Hillcoat,104,Action,3048693
2000000,4905000,Yul Brynner,John Sturges,128,Action,2905000
2000000,11540607,Hilary Swank,Kimberly Peirce,118,Crime,9540607
2000000,124494,Jeffrey Falcon,Lance Mungia,91,Action,-1875506
2000000,622806,Maggie Gyllenhaal,Laurie Collyer,96,Drama,-1377194
2000000,1477002,Bel Powley,Marielle Heller,102,Drama,-522998
2000000,1568749,Ethan Hawke,Michael Almereyda,112,Drama,-431251
2000000,120620,Paul Kaye,Michael Dowse,90,Drama,-1879380
2000000,42070,Matthias Schoenaerts,Micha√´l R. Roskam,124,Crime,-1957930
2000000,27379978,Sidney Poitier,Norman Jewison,109,Crime,25379978
2000000,725131,Nicolas Cage,Robert Bierman,103,Comedy,-1274869
2000000,13129846,Gregory Peck,Robert Mulligan,129,Crime,11129846
2000000,2260622,Warwick Davis,Rodman Flender,85,Comedy,260622
2000000,300000,Crusoe Kurddal,Rolf de Heer,90,Adventure,-1700000
2000000,45431,Christina Hendricks,Ryan Gosling,95,Fantasy,-1954569
2000000,13167232,Dee Wallace,Stephen Herek,82,Comedy,11167232
2000000,48390,Samantha Morton,Steven Bernstein,91,Drama,-1951610
2000000,4635300,Tom Hardy,Steven Knight,85,Drama,2635300
2000000,572809,Sarah Butler,Steven R. Monroe,108,Thriller,-1427191
2000000,2506446,David Duchovny,Steven Soderbergh,96,Comedy,506446
2000000,18344729,Woody Allen,Woody Allen,89,Science Fiction,16344729
2000000,18016290,Woody Allen,Woody Allen,88,Comedy,16016290
2079000,4099000,Aamir Khan,Farhan Akhtar,183,Drama,2020000
2135161,7000000,Tippi Hedren,Alfred Hitchcock,130,Crime,4864839
2200000,136400000,Ali MacGraw,Arthur Hiller,99,Drama,134200000
2200000,21930418,Melanie Kinnaman,Danny Steinmann,92,Horror,19730418
2200000,3251794,Dustin Hoffman,Sam Peckinpah,118,Crime,1051794
2200000,26589000,Malcolm McDowell,Stanley Kubrick,136,Science Fiction,24389000
2300000,11100000,Imran Khan,Abbas Tyrewala,155,Drama,8800000
2300000,35000000,Brad Davis,Alan Parker,121,Drama,32700000
2300000,20000000,Dennis Quaid,Peter Yates,100,Drama,17700000
2380000,8176544,Thomas Turgoose,Shane Meadows,101,Drama,5796544
2400000,88273,Aubrey Plaza,Jeff Baena,90,Romance,-2311727
2410000,10755447,Chuck Norris,Lance Hool,100,Action,8345447
2500000,52604,Danielle Harris,Adam Green,89,Horror,-2447396
2500000,107559,Leonor Varela,Alex Rivera,90,Drama,-2392441
2500000,11403529,Tippi Hedren,Alfred Hitchcock,119,Horror,8903529
2500000,50700000,Warren Beatty,Arthur Penn,111,Crime,48200000
2500000,9500000,Audrey Hepburn,Blake Edwards,110,Comedy,7000000
2500000,12348905,Roddy McDowall,Don Taylor,98,Action,9848905
2500000,5214043,Keanu Reeves,Eli Roth,99,Drama,2714043
2500000,205068,Patty Mullen,Frank Henenlotter,85,Comedy,-2294932
2500000,3358,Tomer Sisley,Fr√©d√©ric Jardin,98,Action,-2496642
2500000,4729352,Matt Dillon,Gus Van Sant,100,Crime,2229352
2500000,3325038,Frank Langella,Jake Schreier,85,Science Fiction,825038
2500000,324138,Rainn Wilson,James Gunn,96,Comedy,-2175862
2500000,6854611,Miles Teller,James Ponsoldt,95,Comedy,4354611
2500000,352810,Mira Sorvino,Jon Gunn,100,Drama,-2147190
2500000,1189315,Amanda Donohoe,Ken Russell,93,Comedy,-1310685
2500000,60141683,Marlon Wayans,Michael Tiddes,86,Comedy,57641683
2500000,26386000,Christopher Reid,Reginald Hudlin,100,Comedy,23886000
2500000,5535405,Ethan Hawke,Richard Linklater,105,Drama,3035405
2500000,25533818,Jamie Lee Curtis,Rick Rosenthal,92,Horror,23033818
2500000,3003,Ashley Hinshaw,Stephen Elliott,102,Drama,-2496997
2500000,78898765,Sean Connery,Terence Young,115,Action,76398765
2500000,14400000,Tom Atkins,Tommy Lee Wallace,96,Horror,11900000
2500000,26781723,Zach Braff,Zach Braff,102,Comedy,24281723
2550000,22812411,Chuck Norris,Joseph Zito,101,Action,20262411
2600000,1479042,Stefania Rocca,Dario Argento,103,Horror,-1120958
2600000,119500000,Cleavon Little,Mel Brooks,93,Comedy,116900000
2600000,3166000,Jeff Clark,Stacy Peralta,105,Documentary,566000
2650000,3100000,Burt Lancaster,John Frankenheimer,143,Drama,450000
2700000,37799643,Kelly Reno,Carroll Ballard,118,Adventure,35099643
2700000,141000000,John Belushi,John Landis,109,Comedy,138300000
2700000,3500000,Charlie Sheen,Mike Marvin,93,Romance,800000
2700000,15992615,Ethan Hawke,Richard Linklater,80,Drama,13292615
2700000,5000000,Charles Bronson,Walter Hill,93,Drama,2300000
2800000,26279000,Sylvia Kristel,Alan Myerson,87,Romance,23479000
2800000,19170001,Kane Hodder,John Carl Buechler,88,Horror,16370001
2800000,1826705,Michael Parks,Kevin Smith,102,Comedy,-973295
2800000,86273333,Gene Wilder,Mel Brooks,106,Comedy,83473333
2800000,60922980,Gregory Peck,Richard Donner,111,Horror,58122980
2840000,11620000,Sridevi Kapoor,Gauri Shinde,133,Drama,8780000
2900000,5000000,Glenn Ford,Frank Capra,136,Comedy,2100000
2900000,74918,Luke Evans,Ry√ªhei Kitamura,86,Horror,-2825082
2900000,296557,Michael Jai White,Scott Sanders,90,Action,-2603443
2962051,3011195,Jeffrey Wright,Julian Schnabel,108,Drama,49144
3000000,67790117,Priscilla C. Shirer,Alex Kendrick,120,Drama,64790117
3000000,153155,Laura Dern,Alexander Payne,104,Drama,-2846845
3000000,13000000,Paul Newman,Alfred Hitchcock,128,Mystery,10000000
3000000,2357852,Katie Jarvis,Andrea Arnold,123,Drama,-642148
3000000,1675381,Clancy Brown,Anthony Leonardi III,100,Horror,-1324619
3000000,3221568,Mickey Rourke,Barbet Schroeder,100,Comedy,221568
3000000,33946224,Paul Mercurio,Baz Luhrmann,94,Comedy,30946224
3000000,25000000,Jack Lemmon,Billy Wilder,125,Comedy,22000000
3000000,4000000,James Cagney,Billy Wilder,115,Comedy,1000000
3000000,21000000,Alan Young,Burny Mattinson,26,Family,18000000
3000000,23144499,Kevin Zegers,Charles Martin Smith,98,Comedy,20144499
3000000,3830137,Anjelica Huston,Clark Gregg,92,Comedy,830137
3000000,3076820,Rose McGowan,Darren Stein,87,Comedy,76820
3000000,3010,Alice Eve,David Brooks,90,Horror,-2996990
3000000,7282851,James Le Gros,Don Coscarelli,97,Action,4282851
3000000,5923000,DMX,Ernest R. Dickerson,88,Action,2923000
3000000,7100000,Jerry Lewis,Frank Tashlin,91,Comedy,4100000
3000000,216166,James Farentino,Gary Sherman,94,Horror,-2783834
3000000,695269,Karl Glusman,Gaspar No√©,134,Drama,-2304731
3000000,9879971,Presley Chweneyagae,Gavin Hood,94,Crime,6879971
3000000,10012022,Alex Frost,Gus Van Sant,81,Drama,7012022
3000000,29999213,Robert Englund,Jack Sholder,87,Horror,26999213
3000000,47000000,Charlton Heston,Jack Smight,107,Action,44000000
3000000,89328627,Lena Headey,James DeMonaco,86,Science Fiction,86328627
3000000,20966644,Maggie Smith,James Ivory,117,Drama,17966644
3000000,672648,Rutger Hauer,Jason Eisener,86,Action,-2327352
3000000,18492362,Jay Chandrasekhar,Jay Chandrasekhar,100,Comedy,15492362
3000000,14182492,Donald Pleasence,John Carpenter,101,Horror,11182492
3000000,2037545,Mark Ruffalo,John Curran,101,Drama,-962455
3000000,12000000,Richard Burton,John Huston,125,Drama,9000000
3000000,23509382,Jim Varney,John R. Cherry III,92,Comedy,20509382
3000000,11947954,Kirsten Dunst,Leslye Headland,87,Comedy,8947954
3000000,4000000,Gene Wilder,Mel Stuart,100,Family,1000000
3000000,22000000,Charles Bronson,Michael Winner,93,Action,19000000
3000000,11718595,Dave Chappelle,Michel Gondry,100,Comedy,8718595
3000000,104397102,Anne Bancroft,Mike Nichols,106,Comedy,101397102
3000000,108981275,Jack Nicholson,Milo≈° Forman,133,Drama,105981275
3000000,4109095,Indira Varma,Mira Nair,117,Drama,1109095
3000000,15119639,Toni Collette,P.J. Hogan,106,Drama,12119639
3000000,2503829,Charles Berling,Patrice Leconte,102,Comedy,-496171
3000000,222559,Philip Baker Hall,Paul Thomas Anderson,96,Drama,-2777441
3000000,242623,Tim Balme,Peter Jackson,104,Horror,-2757377
3000000,11176469,Ethan Hawke,Richard Linklater,108,Romance,8176469
3000000,18637690,Ryan Reynolds,Rob McKittrick,94,Comedy,15637690
3000000,77712439,Ethan Hawke,Scott Derrickson,110,Horror,74712439
3000000,18097,Carla Gugino,Sebastian Gutierrez,92,Comedy,-2981903
3000000,29800000,Al Pacino,Sidney Lumet,129,Crime,26800000
3000000,10000000,Spencer Tracy,Stanley Kramer,186,Drama,7000000
3000000,1145404,Anthony Edwards,Steve De Jarnatt,87,Science Fiction,-1854596
3000000,12800000,Goldie Hawn,Steven Spielberg,110,Action,9800000
3000000,16217773,Paul Newman,Stuart Rosenberg,126,Crime,13217773
3000000,18999718,James Franciscus,Ted Post,95,Adventure,15999718
3000000,14418922,Catherine Mary Stewart,Thom Eberhardt,95,Action,11418922
3000000,177512032,Katie Featherston,Tod Williams,91,Horror,174512032
3000000,2807390,Jane Adams,Todd Solondz,139,Comedy,-192610
3000000,19472057,Thom Mathews,Tom McLoughlin,86,Horror,16472057
3000000,3387000,Maria Bello,Will Canon,83,Thriller,387000
3000000,22000,Lauren German,Xavier Gens,112,Science Fiction,-2978000
3200000,10000000,Jim Carrey,Howard Storm,94,Horror,6800000
3200000,8000000,John Wayne,John Ford,123,Western,4800000
3200000,5332926,Ewan McGregor,Mike Mills,105,Drama,2132926
3200000,33395426,Mia Farrow,Roman Polanski,136,Horror,30195426
3300000,13993093,Miles Teller,Damien Chazelle,105,Drama,10693093
3300000,64110728,Olivia Wilde,David Gelb,83,Thriller,60810728
3352254,58831997,Steve McQueen,Sam Peckinpah,118,Action,55479743
3400000,9444018,Josh Stewart,Marcus Dunstan,88,Horror,6044018
3400000,31063038,Mel Brooks,Mel Brooks,94,Comedy,27663038
3500000,27900000,Tyrin Turner,Albert Hughes,97,Drama,24400000
3500000,12600000,Jon Finch,Alfred Hitchcock,116,Crime,9100000
3500000,2000000,Marlon Brando,Charles Chaplin,120,Comedy,-1500000
3500000,54947,Asia Argento,Dario Argento,102,Horror,-3445053
3500000,5231128,David Boreanaz,Dave Bullock,75,Action,1731128
3500000,9482579,Edward Burns,Edward Burns,96,Comedy,5982579
3500000,28215918,Ice Cube,F. Gary Gray,91,Comedy,24715918
3500000,34000000,Lori Cardille,George A. Romero,102,Horror,30500000
3500000,20659423,Tom Burlinson,George T. Miller,104,Drama,17159423
3500000,124900000,Sean Connery,Guy Hamilton,110,Adventure,121400000
3500000,19504039,Kevin Spacey,J.C. Chandor,107,Thriller,16004039
3500000,2341309,Robert Patrick,James Yukich,89,Action,-1158691
3500000,5155325,Michelle Monaghan,Jay Oliva,79,Animation,1655325
3500000,1115493,Julia Ormond,Jennifer Chambers Lynch,97,Thriller,-2384507
3500000,83453539,Robert Hays,Jim Abrahams,88,Comedy,79953539
3500000,237113184,John Travolta,John Badham,118,Drama,233613184
3500000,14000000,George Kennedy,Michael Gornick,92,Horror,10500000
3500000,7700000,Ben Stein,Nathan Frankowski,90,Documentary,4200000
3500000,257850122,Robert Carlyle,Peter Cattaneo,91,Comedy,254350122
3500000,44462,Woody Harrelson,Peter Stebbings,101,Drama,-3455538
3500000,24046533,Donald Sutherland,Philip Kaufman,115,Horror,20546533
3500000,81600000,Donald Sutherland,Robert Altman,116,Comedy,78100000
3500000,40423945,Anya Taylor-Joy,Robert Eggers,92,Mystery,36923945
3500000,16000000,Patrick Wayne,Sam Wanamaker,113,Action,12500000
3500000,25174316,Keri Russell,Scott Stewart,97,Science Fiction,21674316
3500159,76578641,Parminder Nagra,Gurinder Chadha,112,Comedy,73078482
3600000,44785053,Dustin Hoffman,John Schlesinger,113,Drama,41185053
3600000,49800000,Nicolas Cage,Mike Figgis,112,Drama,46200000
3600000,5923044,Bruce Campbell,Sam Raimi,84,Horror,2323044
3700000,31800000,Clint Eastwood,Clint Eastwood,135,Drama,28100000
3700000,3338228,Jim Caviezel,Simon Brand,98,Crime,-361772
3705538,62548947,Stephen Rea,Neil Jordan,112,Romance,58843409
3716946,3500000,Jason Robards,Sam Peckinpah,121,Action,-216946
3730500,6294161,Ray Winstone,Nick Love,112,Action,2563661
3800000,28200000,Om Puri,Damien O'Donnell,97,Comedy,24400000
3800000,23689877,Faye Dunaway,Sidney Lumet,121,Drama,19889877
4000000,55125,Juno Temple,Abe Sylvia,90,Drama,-3944875
4000000,92921203,Jennifer Beals,Adrian Lyne,95,Drama,88921203
4000000,2826523,Gary Oldman,Alex Cox,112,Drama,-1173477
4000000,9797098,Jennifer Rubin,Andrew Fleming,86,Horror,5797098
4000000,350006,Annette Bening,Arie Posin,92,Drama,-3649994
4000000,6101046,Evan Rachel Wood,Aristomenis Tsirbas,85,Science Fiction,2101046
4000000,125728258,Dan Monahan,Bob Clark,94,Comedy,121728258
4000000,4630045,Dax Shepard,Bob Odenkirk,84,Comedy,630045
4000000,4100000,Daveigh Chase,Chris Fisher,103,Thriller,100000
4000000,215880014,Rod Taylor,Clyde Geronimi,79,Adventure,211880014
4000000,14237000,Clu Gulager,Dan O'Bannon,91,Comedy,10237000
4000000,16491080,Ewan McGregor,Danny Boyle,93,Drama,12491080
4000000,152925093,Tobin Bell,Darren Lynn Bousman,92,Horror,148925093
4000000,866999,Stephanie Leonidas,Dave McKean,101,Adventure,-3133001
4000000,143101,Al Pacino,David Gordon Green,97,Drama,-3856899
4000000,2365467,Nicolas Cage,David Gordon Green,118,Drama,-1634533
4000000,16853487,Jean-Claude Van Damme,Deran Sarafian,93,Action,12853487
4000000,35976000,Clint Eastwood,Don Siegel,102,Action,31976000
4000000,30039392,Simon Pegg,Edgar Wright,99,Horror,26039392
4000000,146402,Javier Bardem,Fernando Le√≥n de Aranoa,113,Drama,-3853598
4000000,6870249,Neil Dudgeon,Garth Jennings,96,Comedy,2870249
4000000,143191,Alan van Sprang,George A. Romero,90,Horror,-3856809
4000000,12121618,Richard Roundtree,Gordon Parks,100,Adventure,8121618
4000000,187112,Arnold Schwarzenegger,Henry Hobson,95,Horror,-3812888
4000000,253899,J.K. Simmons,Jim Kohlberg,105,Drama,-3746101
4000000,13008928,Roddy Piper,John Carpenter,94,Action,9008928
4000000,2426851,Ben Kingsley,John Dahl,90,Comedy,-1573149
4000000,5000000,Steve McQueen,John Sturges,172,Adventure,1000000
4000000,25345000,Melissa George,Julian Gilbey,99,Adventure,21345000
4000000,1104682,Michael Parks,Kevin Smith,88,Horror,-2895318
4000000,16675000,Bruce Ramsay,Kevin Yagher,86,Horror,12675000
4000000,34705850,Julianne Moore,Lisa Cholodenko,106,Comedy,30705850
4000000,44909486,Halle Berry,Marc Forster,111,Drama,40909486
4000000,530048,Martijn Lakemeier,Martin Koolhoven,103,Drama,-3469952
4000000,35564473,Michael Moore,Michael Moore,120,Documentary,31564473
4000000,13401952,Samuel Anderson,Nicholas Hytner,109,Comedy,9401952
4000000,3468572,Eric Bogosian,Oliver Stone,110,Drama,-531428
4000000,30471420,Christopher Guard,Ralph Bakshi,132,Drama,26471420
4000000,44349000,Ellar Coltrane,Richard Linklater,164,Drama,40349000
4000000,50163103,Jennifer Lopez,Rob Cohen,91,Thriller,46163103
4000000,46474,Daniel Radcliffe,Rod Hardy,105,Drama,-3953526
4000000,355688,Ellen Barkin,Sam Levinson,119,Comedy,-3644312
4000000,119723856,Bill Murray,Sofia Coppola,102,Drama,115723856
4000000,13474588,Cary Grant,Stanley Donen,113,Comedy,9474588
4000000,56666667,Spencer Tracy,Stanley Kramer,108,Comedy,52666667
4000000,36690067,Dana Kimmell,Steve Miner,95,Horror,32690067
4000000,11000000,Audrey Hepburn,Terence Young,108,Crime,7000000
4000000,20045115,Graham Chapman,Terry Jones,94,Comedy,16045115
4000000,29456000,Richard Anconina,Thomas Gilou,100,Comedy,25456000
4000000,9221,Joe Swanberg,Ti West,99,Mystery,-3990779
4000000,600896,Brenton Thwaites,William Eubank,95,Thriller,-3399104
4000000,8059140,Ashley Judd,William Friedkin,102,Horror,4059140
4000000,205843612,Phil Harris,Wolfgang Reitherman,78,Family,201843612
4000000,55675257,Phil Harris,Wolfgang Reitherman,78,Animation,51675257
4000000,31584901,Scarlett Johansson,Woody Allen,96,Comedy,27584901
4000000,38251425,Woody Allen,Woody Allen,93,Comedy,34251425
4000000,9064511,Colin Farrell,Yorgos Lanthimos,118,Thriller,5064511
4100000,14225876,Stephen Lack,David Cronenberg,103,Horror,10125876
4200000,5835247,Patricia Tallman,Tom Savini,88,Horror,1635247
4317946,14624826,Regina Advento,Wim Wenders,106,Documentary,10306880
4361898,3031801,Luke Kirby,mile Gaudreault,92,Comedy,-1330097
4500000,3606395,Liam Neeson,Agnieszka Wojtowicz-Vosloo,104,Drama,-893605
4500000,27092880,Sean Penn,Amy Heckerling,90,Comedy,22592880
4500000,7390108,Ellen Burstyn,Darren Aronofsky,102,Drama,2890108
4500000,123820,Katie Holmes,Galt Niederhoffer,95,Comedy,-4376180
4500000,81198894,Steve Guttenberg,Hugh Wilson,96,Comedy,76698894
4500000,7011317,Jennifer Tilly,Lana Wachowski,108,Romance,2511317
4500000,10609321,Griffin Dunne,Martin Scorsese,97,Comedy,6109321
4500000,3813293,Scott Grimes,Mick Garris,86,Thriller,-686707
4500000,13417292,Timothy Spall,Mike Leigh,142,Drama,8917292
4500000,58853106,Brooke Shields,Randal Kleiser,104,Romance,54353106
4500000,1261000,Jeffrey Combs,Stuart Gordon,86,Horror,-3239000
4500000,744816,Ally Sheedy,Todd Solondz,97,Comedy,-3755184
4600000,23198652,Liam James,Jim Rash,103,Comedy,18598652
4600000,1163967,Emma Roberts,Noel Clarke,117,Action,-3436033
4653000,6000000,John Wayne,Howard Hawks,120,Action,1347000
4700000,8025872,Dennis Hopper,Tobe Hooper,101,Horror,3325872
4750000,206871,Jenna Dewan,Jeremy Haft,98,Fantasy,-4543129
4798235,209696,Rebecca Hall,Nick Murphy,107,Drama,-4588539
4800000,80578934,Jay Hernandez,Eli Roth,94,Horror,75778934
4800000,10337387,Ryan Gosling,Nicolas Winding Refn,90,Drama,5537387
4800000,22743674,Richard Gere,Paul Schrader,117,Thriller,17943674
4900000,2159041,Keri Russell,Jerusha Hess,97,Comedy,-2740959
4900000,3494070,Anne Dorval,Xavier Dolan,138,Drama,-1405930
5000000,2367161,Dan Stevens,Adam Wingard,99,Mystery,-2632839
5000000,10429707,Sarah Drew,Andrew Erwin,98,Comedy,5429707
5000000,12534961,Kevin Bernhardt,Anthony Hickox,93,Horror,7534961
5000000,3263585,Ian Holm,Atom Egoyan,112,Drama,-1736415
5000000,346592,Aaron Eckhart,Bernie Goldmann,97,Comedy,-4653408
5000000,41833347,Peter Sellers,Blake Edwards,113,Comedy,36833347
5000000,8203235,Christian Bale,Brad Anderson,101,Thriller,3203235
5000000,19905359,Sylvester Stallone,Bruce Malmuth,99,Action,14905359
5000000,16174377,Amy Adams,Christine Jeffs,102,Comedy,11174377
5000000,86362372,Richard Cabral,Christopher B. Landon,84,Horror,81362372
5000000,44793222,Robert Englund,Chuck Russell,96,Horror,39793222
5000000,2614773,Rebecca Hall,Dan Rush,97,Comedy,-2385227
5000000,82719885,Cillian Murphy,Danny Boyle,113,Horror,77719885
5000000,26010864,Anthony Hopkins,David Lynch,124,Drama,21010864
5000000,1000000,James Frecheville,David Mich√¥d,113,Drama,-4000000
5000000,295206,Janeane Garofalo,David Wain,97,Comedy,-4704794
5000000,11642254,Donald Pleasence,Dominique Othenin-Girard,96,Horror,6642254
5000000,5879254,Christina Ricci,Don Roos,105,Comedy,879254
5000000,9760104,Sam Rockwell,Duncan Jones,97,Science Fiction,4760104
5000000,17768757,Donald Pleasence,Dwight H. Little,88,Horror,12768757
5000000,15179302,Ashley Bell,Ed Gass-Donnelly,88,Horror,10179302
5000000,6833445,Lorenza Izzo,Eli Roth,100,Horror,1833445
5000000,20146880,Omar Epps,Ernest R. Dickerson,96,Action,15146880
5000000,742898,Seth Green,Fenton Bailey,98,Comedy,-4257102
5000000,75143,Olivia Wilde,Geoff Moore,91,Drama,-4924857
5000000,42000000,Paul McGann,Geoffrey Sax,89,TV Movie,37000000
5000000,25562924,Ryan Robbins,Gonzalo L√≥pez-Gallego,86,Horror,20562924
5000000,7230000,Harrison Ford,Guy Hamilton,118,Action,2230000
5000000,31724284,James Franco,Harmony Korine,94,Drama,26724284
5000000,205703818,Katie Featherston,Henry Joost,83,Horror,200703818
5000000,142817992,Katie Featherston,Henry Joost,95,Horror,137817992
5000000,4013786,Maggie Smith,Israel Horovitz,107,Romance,-986214
5000000,1980338,Bill Pullman,Jake Kasdan,116,Comedy,-3019662
5000000,2466444,Val Kilmer,James Cox,104,Crime,-2533556
5000000,55198285,Matthew McConaughey,Jean-Marc Vall√©e,117,Drama,50198285
5000000,3099314,Michael Shannon,Jeff Nichols,120,Thriller,-1900686
5000000,64282312,Johnny Knoxville,Jeff Tremaine,87,Comedy,59282312
5000000,15116634,Donald Pleasence,Joe Chappelle,88,Horror,10116634
5000000,58978653,Jason Bateman,Joel Edgerton,108,Thriller,53978653
5000000,368744044,Nia Vardalos,Joel Zwick,95,Comedy,363744044
5000000,5129058,Nicole Kidman,John Cameron Mitchell,91,Drama,129058
5000000,4856298,Colin Farrell,John Crowley,105,Romance,-143702
5000000,54418872,Owen Wilson,John Erick Dowdle,103,Action,49418872
5000000,40100000,Perdita Weeks,John Erick Dowdle,93,Horror,35100000
5000000,8493728,Danielle Panabaker,John Gulager,83,Horror,3493728
5000000,13269963,Chris Cooper,John Sayles,135,Drama,8269963
5000000,5476060,Vince Vaughn,Jon Favreau,94,Action,476060
5000000,2333684,Aubrey Peeples,Jon M. Chu,119,Drama,-2666316
5000000,1296184,John Cusack,Joshua Seftel,106,Action,-3703816
5000000,3569939,Tami Erin,Ken Annakin,100,Fantasy,-1430061
5000000,34251525,Oliver Reed,Ken Russell,111,Drama,29251525
5000000,26888376,Brian O'Halloran,Kevin Smith,97,Comedy,21888376
5000000,98450062,Olivia DeJonge,M. Night Shyamalan,94,Horror,93450062
5000000,50000000,Barbara Parkins,Mark Robson,123,Music,45000000
5000000,2450846,Jeremy Renner,Michael Cuesta,112,Thriller,-2549154
5000000,4842699,Kate Bosworth,Michael Polish,121,Drama,-157301
5000000,3833507,John Paul Tremblay,Mike Clattenburg,95,Action,-1166493
5000000,44030246,Katee Sackhoff,Mike Flanagan,104,Horror,39030246
5000000,502758,Ken Ogata,Paul Schrader,121,Drama,-4497242
5000000,328203506,Paul Hogan,Peter Faiman,97,Adventure,323203506
5000000,3049135,Melanie Lynskey,Peter Jackson,99,Drama,-1950865
5000000,1189612,Forest Whitaker,Philippe Caland,90,Horror,-3810388
5000000,4040588,Alan Rickman,Randall Miller,110,Comedy,-959412
5000000,34725000,Anthony Perkins,Richard Franklin,113,Horror,29725000
5000000,14000000,Kane Hodder,Rob Hedden,100,Horror,9000000
5000000,3142154,Patrick Dempsey,Rob Minkoff,87,Mystery,-1857846
5000000,15738769,Andrew Divoff,Robert Kurtzman,90,Horror,10738769
5000000,1862805,Hugh Grant,Roman Polanski,139,Thriller,-3137195
5000000,84563118,Gene Hackman,Ronald Neame,117,Action,79563118
5000000,110000000,Jamie Bell,Stephen Daldry,110,Drama,105000000
5000000,12232628,Chuck Norris,Steve Carver,107,Action,7232628
5000000,102529779,Olivia Cooke,Stiles White,89,Horror,97529779
5000000,27400000,Madonna,Susan Seidelman,104,Drama,22400000
5000000,42365581,John Cleese,Terry Gilliam,116,Family,37365581
5000000,38610009,Johanna Braddy,Toby Wilkins,90,Horror,33610009
5000000,38275483,Ryan Reynolds,Walt Becker,92,Comedy,33275483
5000000,16554699,Michael Murphy,Wes Craven,109,Thriller,11554699
5037000,14483352,Jeffrey Hunter,Nicholas Ray,168,Drama,9446352
5115000,12000000,Stephen Boyd,Richard Fleischer,100,Adventure,6885000
5200000,14723313,Artur ≈ªmijewski,Andrzej Wajda,118,Drama,9523313
5500000,26414658,Clint Eastwood,Clint Eastwood,109,Drama,20914658
5500000,159616327,Paul Newman,George Roy Hill,129,Comedy,154116327
5500000,58972904,Ben Cross,Hugh Hudson,123,Drama,53472904
5500000,5000000,Jessica Chastain,Liv Ullmann,120,Drama,-500000
5500000,3000000,Ethan Hawke,Michael Spierig,97,Science Fiction,-2500000
5500000,42300873,Steve McQueen,Peter Yates,113,Action,36800873
5500000,801000,Gregory Harrison,Russell Mulcahy,95,Horror,-4699000
5500000,5483299,Zach Braff,Zach Braff,120,Drama,-16701
5600000,8139,Thomas Kretschmann,Dario Argento,109,Horror,-5591861
5600000,29950000,Stuart Whitman,Ken Annakin,138,Action,24350000
5773100,18144030,Nichola Burley,Max Giwa,98,Drama,12370930
5800000,33395426,Charlton Heston,Franklin J. Schaffner,112,Adventure,27595426
5900000,23000000,Brendan O'Carroll,Ben Kellett,94,Comedy,17100000
5952000,2120439,James Woods,David Cronenberg,87,Horror,-3831561
5990000,19450000,Sudeep,S.S. Rajamouli,145,Science Fiction,13460000
6000000,5093707,Chuck Norris,Aaron Norris,86,Action,-906293
6000000,13609396,Cary Elwes,Alan Shapiro,89,Drama,7609396
6000000,15071,Evan Rachel Wood,Andrew Fleming,90,Comedy,-5984929
6000000,25792310,Virginia Madsen,Bernard Rose,99,Drama,19792310
6000000,33833201,Peter Sellers,Blake Edwards,103,Comedy,27833201
6000000,13231461,Bradley Cooper,Brian Klugman,96,Drama,7231461
6000000,5617391,Kevin Conroy,Bruce Timm,76,Animation,-382609
6000000,23341568,Stephen Baldwin,Bryan Singer,106,Drama,17341568
6000000,90777,Idris Elba,Cary Fukunaga,137,Drama,-5909223
6000000,18750246,Bob Balaban,Christopher Guest,91,Comedy,12750246
6000000,44703995,Mickey Rourke,Darren Aronofsky,109,Drama,38703995
6000000,2025238,Chelcie Ross,David Atkins,95,Comedy,-3974762
6000000,1193062,Vanilla Ice,David Kellogg,91,Drama,-4806938
6000000,8551228,Isabella Rossellini,David Lynch,120,Crime,2551228
6000000,46616067,Sean Penn,Dennis Hopper,120,Action,40616067
6000000,22231658,Gwyneth Paltrow,Douglas McGrath,121,Comedy,16231658
6000000,213954274,Jennifer Grey,Emile Ardolino,100,Drama,207954274
6000000,1300000,Tilda Swinton,Erick Zonca,138,Drama,-4700000
6000000,245066411,Marlon Brando,Francis Ford Coppola,175,Drama,239066411
6000000,31081,Elijah Wood,Franck Khalfoun,89,Horror,-5968919
6000000,161000000,Barbra Streisand,Frank Pierson,139,Drama,155000000
6000000,18197398,Cuba Gooding Jr.,Fred Savage,89,Comedy,12197398
6000000,102308889,Paul Newman,George Roy Hill,110,History,96308889
6000000,39846344,Chevy Chase,Harold Ramis,98,Comedy,33846344
6000000,28900000,Gregory Peck,J. Lee Thompson,158,Action,22900000
6000000,43656822,Natalie Wood,Jerome Robbins,152,Music,37656822
6000000,30000000,Jack Lemmon,Jerry Jameson,114,Action,24000000
6000000,29180280,Nicolas Cage,Joel Coen,94,Comedy,23180280
6000000,50000000,Kurt Russell,John Carpenter,99,Science Fiction,44000000
6000000,70136369,Matthew Broderick,John Hughes,103,Drama,64136369
6000000,12974636,Ally Sheedy,John Lafia,97,Horror,6974636
6000000,19560274,Brendan Gleeson,John Michael McDonagh,96,Action,13560274
6000000,28202109,Jim Varney,John R. Cherry III,95,Comedy,22202109
6000000,2899975,Ben Kingsley,Jonathan Levine,99,Drama,-3100025
6000000,32251,Anne Hathaway,Kate Barker-Froyland,86,Drama,-5967749
6000000,48027970,Forest Whitaker,Kevin Macdonald,121,Drama,42027970
6000000,5206,Orlando Bloom,Lance Daly,93,Drama,-5994794
6000000,35401758,Brie Larson,Lenny Abrahamson,117,Drama,29401758
6000000,4398989,Sarah Michelle Gellar,Mark Tarlov,95,Comedy,-1601011
6000000,4300000,Marlon Brando,Marlon Brando,141,Western,-1700000
6000000,11122090,Zac Efron,Max Joseph,96,Drama,5122090
6000000,14717854,Richard Harris,Michael Anderson,92,Drama,8717854
6000000,42721196,Andrew McCarthy,Michael Gottlieb,89,Fantasy,36721196
6000000,3661757,Scott Glenn,Michael Mann,96,Drama,-2338243
6000000,119114517,Michael Moore,Michael Moore,122,Documentary,113114517
6000000,705308,Patricia Arquette,Michel Gondry,96,Drama,-5294692
6000000,254700832,Hugh Grant,Mike Newell,117,Comedy,248700832
6000000,38435947,Tom Hanks,Neal Israel,105,Comedy,32435947
6000000,41387687,Maggie Smith,Nicholas Hytner,104,Comedy,35387687
6000000,138530565,Tom Berenger,Oliver Stone,120,Drama,132530565
6000000,6330054,Nick Nolte,Paul Schrader,114,Drama,330054
6000000,58000000,Gwyneth Paltrow,Peter Howitt,99,Comedy,52000000
6000000,10278575,Mel Gibson,Peter Weir,115,War,4278575
6000000,181813770,John Travolta,Randal Kleiser,110,Music,175813770
6000000,6670712,Andy Garc√≠a,Raymond De Felitta,104,Drama,670712
6000000,1270522,Jake Gyllenhaal,Richard Kelly,113,Fantasy,-4729478
6000000,1020921,Morgan Freeman,Richard Loncraine,92,Drama,-4979079
6000000,25059640,Omar Epps,Rick Famuyiwa,106,Comedy,19059640
6000000,6852450,Ben Affleck,Risa Bramon Garcia,101,Comedy,852450
6000000,3485127,Kristen Bell,Rob Thomas,107,Comedy,-2514873
6000000,102272727,Julie Andrews,Robert Stevenson,139,Comedy,96272727
6000000,30000000,Jack Nicholson,Roman Polanski,130,Crime,24000000
6000000,69497,Matthew McConaughey,S.R. Bindler,85,Comedy,-5930503
6000000,1066471,Alexander Skarsg√•rd,Scott McGehee,93,Drama,-4933529
6000000,24078196,Jean-Claude Van Damme,Sheldon Lettich,105,Action,18078196
6000000,3283371,Mark Dacascos,Sheldon Lettich,99,Action,-2716629
6000000,10409377,James Woods,Sofia Coppola,97,Drama,4409377
6000000,391410,Kim Basinger,Susan Montford,108,Action,-5608590
6000000,40940662,Paul Reubens,Tim Burton,90,Adventure,34940662
6000000,14278900,Fred Savage,Todd Holland,100,Adventure,8278900
6000000,30471,Willem Dafoe,Troy Duffy,108,Action,-5969529
6000000,57231524,Tyler Perry,Tyler Perry,110,Drama,51231524
6200000,9205924,James Karen,Ken Wiederhorn,89,Comedy,3005924
6200000,63541777,Tom Cruise,Paul Brickman,98,Comedy,57341777
6244087,638641,Ernest Borgnine,Sam Peckinpah,145,Adventure,-5605446
6300000,419953,Andrea Riseborough,James Marsh,101,Thriller,-5880047
6400000,2500000,Ewan McGregor,David Mackenzie,93,Drama,-3900000
6400000,78371200,Arnold Schwarzenegger,James Cameron,108,Action,71971200
6400000,35057696,Michelle Williams,Simon Curtis,99,Drama,28657696
6400000,40084041,Woody Allen,Woody Allen,107,Comedy,33684041
6500000,33759266,Dan Monahan,Bob Clark,98,Comedy,27259266
6500000,31899000,Michael Caine,Brian De Palma,105,Horror,25399000
6500000,28451622,Sarah Polley,Doug Liman,98,Crime,21951622
6500000,13865435,Ashley Hinshaw,Gr√©gory Levasseur,89,Horror,7365435
6500000,26533200,Robert Redford,Jack Clayton,144,Drama,20033200
6500000,2347000,Sean Penn,James Foley,111,Crime,-4153000
6500000,24793509,Aaron Eckhart,Jason Reitman,92,Comedy,18293509
6500000,12633747,Jason Patric,Joe Carnahan,105,Action,6133747
6500000,23686027,Molly Ringwald,John Hughes,93,Comedy,17186027
6500000,255273813,Annabelle Wallis,John R. Leonetti,99,Horror,248773813
6500000,21709020,Dustin Hoffman,John Schlesinger,125,Thriller,15209020
6500000,57504069,Laurence Fishburne,John Singleton,112,Crime,51004069
6500000,22889018,Cillian Murphy,Ken Loach,124,Drama,16389018
6500000,54215416,Lou Diamond Phillips,Luis Valdez,108,Drama,47715416
6500000,11850214,Daniel Craig,Matthew Vaughn,105,Drama,5350214
6500000,1548955,Colin Farrell,Michael Mayer,96,Romance,-4951045
6500000,13368437,Catherine Keener,Nicole Holofcener,88,Drama,6868437
6500000,1521261,Ben Foster,Oren Moverman,113,Drama,-4978739
6500000,98410061,Sandra Bullock,Paul Haggis,112,Drama,91910061
6500000,37295445,Ossie Davis,Spike Lee,120,Crime,30795445
6500000,17693675,Michael Fassbender,Steve McQueen,100,Drama,11193675
6500000,30218387,Andrew McCarthy,Ted Kotcheff,97,Comedy,23718387
6500000,2401510,Brit Marling,Zal Batmanglij,116,Drama,-4098490
6600000,1554000,Juliette Binoche,Olivier Assayas,124,Drama,-5046000
6600000,37710610,Paula Patton,Salim Akil,112,Comedy,31110610
6700000,1430655,Mark Ruffalo,Maya Forbes,87,Comedy,-5269345
6800000,26518355,William Holden,Don Taylor,107,Action,19718355
6900000,7993039,Jason London,Richard Linklater,102,Comedy,1093039
7000000,49084830,Philip Seymour Hoffman,Bennett Miller,114,Crime,42084830
7000000,1429299,Matt Czuchry,Bob Gosse,106,Comedy,-5570701
7000000,10000000,Gwyneth Paltrow,Christine Jeffs,109,Drama,3000000
7000000,20256975,Carl Weathers,Craig R. Baxley,96,Action,13256975
7000000,9229401,Dolph Lundgren,Craig R. Baxley,91,Action,2229401
7000000,2360281,Jennifer Aniston,Daniel Barnz,102,Drama,-4639719
7000000,48126384,Jake Gyllenhaal,David Ayer,109,Crime,41126384
7000000,14702438,Ben Stiller,David O. Russell,92,Comedy,7702438
7000000,6230276,Drake Bell,Deb Hagan,94,Comedy,-769724
7000000,10229331,Dr. Dre,DJ Pooh,93,Action,3229331
7000000,14665733,Derek Jacobi,Don Bluth,82,Fantasy,7665733
7000000,1100000,Mariel Hemingway,Eric Red,80,Horror,-5900000
7000000,31430334,Michael Stuhlbarg,Ethan Coen,105,Comedy,24430334
7000000,5344577,Jason Beghe,George A. Romero,113,Thriller,-1655423
7000000,54600000,David Strathairn,George Clooney,93,Drama,47600000
7000000,14618727,Minnie Driver,Gina Prince-Bythewood,116,Drama,7618727
7000000,161777836,Roger Moore,Guy Hamilton,121,Adventure,154777836
7000000,97572000,Roger Moore,Guy Hamilton,125,Adventure,90572000
7000000,116700000,Holly Hunter,Jane Campion,121,Romance,109700000
7000000,60611975,William H. Macy,Joel Coen,98,Crime,53611975
7000000,3728888,Kevin Spacey,John Swanbeck,90,Comedy,-3271112
7000000,11000000,John Wayne,John Wayne,142,War,4000000
7000000,3218666,Santiago Segura,lex de la Iglesia,101,Drama,-3781334
7000000,2697930,Elijah Wood,Liev Schreiber,106,Comedy,-4302070
7000000,6147,Ed Harris,Logan Miller,95,Western,-6993853
7000000,6038942,John C. Reilly,Lynne Ramsay,112,Drama,-961058
7000000,79666653,Charlton Heston,Mark Robson,123,Action,72666653
7000000,8373585,Willem Dafoe,Martin Scorsese,164,Drama,1373585
7000000,34266564,Christian Bale,Mary Harron,102,Thriller,27266564
7000000,7644937,Keira Knightley,Massy Tadjedin,90,Drama,644937
7000000,36433975,Allison Miller,Matt Bettinelli-Olpin,89,Horror,29433975
7000000,7292175,Shawn Hatosy,Michael Corrente,96,Romance,292175
7000000,14011454,Omar Epps,Michael Rymer,97,Drama,7011454
7000000,405000,Kate Winslet,Michael Winterbottom,123,Drama,-6595000
7000000,900000,Mark Frechette,Michelangelo Antonioni,110,Drama,-6100000
7000000,10569964,Dennis Quaid,Noam Murro,95,Comedy,3569964
7000000,2062066,Greg Kinnear,Paul Schrader,104,Drama,-4937934
7000000,3646994,Kirsten Dunst,Peter Bogdanovich,114,Drama,-3353006
7000000,81974493,George Lazenby,Peter R. Hunt,142,Adventure,74974493
7000000,573335,Julianne Moore,Peter Sollett,103,Romance,-6426665
7000000,72500000,Robert Englund,Renny Harlin,99,Horror,65500000
7000000,793775,Fred Savage,Richard Greenberg,102,Adventure,-6206225
7000000,16829545,Sid Haig,Rob Zombie,89,Horror,9829545
7000000,8900000,Ben Browder,Robert C. Cooper,97,Adventure,1900000
7000000,25405445,Antonio Banderas,Robert Rodriguez,104,Thriller,18405445
7000000,50888000,Kevin Costner,Ron Shelton,108,Comedy,43888000
7000000,39462438,Jeff Bridges,Scott Cooper,112,Drama,32462438
7000000,453079,Kevin Kline,Shari Springer Berman,108,Comedy,-6546921
7000000,382946,Joseph Gordon-Levitt,Spencer Susser,106,Drama,-6617054
7000000,46488,Sean Bean,Stephen Milburn Anderson,108,Crime,-6953512
7000000,95461682,Dudley Moore,Steve Gordon,97,Comedy,88461682
7000000,167221571,Channing Tatum,Steven Soderbergh,110,Drama,160221571
7000000,470654000,Roy Scheider,Steven Spielberg,124,Horror,463654000
7000000,200182160,Sylvester Stallone,Sylvester Stallone,119,Drama,193182160
7000000,13818181,Jonathan Cherry,Uwe Boll,90,Horror,6818181
7000000,8349430,Harvey Keitel,Wayne Wang,112,Comedy,1349430
7000000,560069,Luke Wilson,Wes Anderson,91,Comedy,-6439931
7000000,19595031,Bill Pullman,Wes Craven,98,Horror,12595031
7200000,68392977,Prince,Albert Magnoli,111,Drama,61192977
7200000,116000000,Sean Connery,Guy Hamilton,120,Adventure,108800000
7200000,12729678,Burt Lancaster,Louis Malle,104,Crime,5529678
7200000,2300000,Nick Pickard,Vladimir Grammatikov,99,Adventure,-4900000
7300000,10329747,Michael Caine,Daniel Barber,103,Thriller,3029747
7400000,7690013,Ice-T,Ernest R. Dickerson,96,Action,290013
7500000,296000000,John Travolta,Amy Heckerling,93,Comedy,288500000
7500000,18869631,Steven Seagal,Andrew Davis,99,Action,11369631
7500000,143000,Matthew Le Nevez,Brett Leonard,97,Action,-7357000
7500000,145793296,Morgan Freeman,Bruce Beresford,99,Comedy,138293296
7500000,62493712,John Cleese,Charles Crichton,108,Comedy,54993712
7500000,231411584,Ellen Page,Jason Reitman,96,Comedy,223911584
7500000,26096852,Carey Mulligan,Lone Scherfig,100,Drama,18596852
7500000,60722734,Joseph Gordon-Levitt,Marc Webb,95,Comedy,53222734
7500000,33736689,Elizabeth Taylor,Mike Nichols,131,Drama,26236689
7500000,1359910,Vanessa Hudgens,Ron Krauss,101,Drama,-6140090
7500000,8135031,Julia Dietze,Timo Vuorensola,93,Action,635031
7700000,21000000,Richard Burton,Brian G. Hutton,155,Adventure,13300000
7700000,1072602,Gerard Butler,Ralph Fiennes,123,Drama,-6627398
7800000,22441323,Charlotte Rampling,Fran√ßois Ozon,102,Thriller,14641323
7920000,14560084,Peter Ustinov,John Guillermin,140,Mystery,6640084
8000000,100915,Kaya Scodelario,Andrea Arnold,129,Drama,-7899085
8000000,426224,Billy Connolly,Andrew Currie,91,Romance,-7573776
8000000,6491240,Keir Gilchrist,Anna Boden,101,Comedy,-1508760
8000000,10400000,Forest Whitaker,Bill Duke,115,Crime,2400000
8000000,2019009,Roy Dupuis,Charles Binam√©,124,Drama,-5980991
8000000,53086,Jennifer Connelly,Claudia Llosa,112,Drama,-7946914
8000000,22201636,Terrence Howard,Craig Brewer,116,Drama,14201636
8000000,852872,Edward Norton,David Jacobson,112,Drama,-7147128
8000000,27187653,Judy Davis,David Lean,163,Drama,19187653
8000000,60641,Jamie Bell,David Mackenzie,95,Drama,-7939359
8000000,43000000,Clint Eastwood,Don Siegel,111,Crime,35000000
8000000,18948425,Keke Palmer,Doug Atchison,112,Drama,10948425
8000000,3759286,Jennifer Jason Leigh,Duke Johnson,90,Animation,-4240714
8000000,8279017,John Malkovich,E. Elias Merhige,92,Drama,279017
8000000,7766240,Wes Bentley,Franck Khalfoun,98,Horror,-233760
8000000,529766,Andy Garc√≠a,Gary Fleder,116,Drama,-7470234
8000000,21028755,Leslie Nielsen,George A. Romero,120,Horror,13028755
8000000,22433275,Corey Haim,Greg Beeman,90,Comedy,14433275
8000000,9630444,John Jarratt,Greg McLean,106,Horror,1630444
8000000,163265,Mia Wasikowska,Gus Van Sant,91,Drama,-7836735
8000000,10130000,Aimee Teegarden,Joe Nussbaum,104,Comedy,2130000
8000000,63464861,Mark Ruffalo,John Carney,104,Comedy,55464861
8000000,2000000,Nicolas Cage,John Dahl,98,Crime,-6000000
8000000,90815558,Ralph Macchio,John G. Avildsen,126,Drama,82815558
8000000,17843379,Melissa Joan Hart,John Schultz,91,Drama,9843379
8000000,29010817,Ren√©e Zellweger,Jonas Elmer,97,Comedy,21010817
8000000,100523181,Greg Kinnear,Jonathan Dayton,102,Comedy,92523181
8000000,39187783,Joseph Gordon-Levitt,Jonathan Levine,100,Comedy,31187783
8000000,3453043,Bill Nighy,Jonathan Lynn,98,Action,-4546957
8000000,1653792,Julie Delpy,Julie Delpy,91,Comedy,-6346208
8000000,35991087,Robert Redford,Ken Kwapis,104,Drama,27991087
8000000,382267,Guy Pearce,Mark Fergus,101,Drama,-7617733
8000000,2275557,Dolph Lundgren,Mark L. Lester,79,Action,-5724443
8000000,17092453,Edward Furlong,Mary Lambert,100,Horror,9092453
8000000,16856124,Jennifer Aniston,Miguel Arteta,93,Drama,8856124
8000000,10848783,Jason Bateman,Mike Judge,92,Comedy,2848783
8000000,18124262,Jim Broadbent,Mike Leigh,129,Comedy,10124262
8000000,41400000,Keisha Castle-Hughes,Niki Caro,101,Drama,33400000
8000000,60378584,Charlize Theron,Patty Jenkins,110,Crime,52378584
8000000,1749457,Felicity Jones,Phil Traill,96,Comedy,-6250543
8000000,213928762,John Travolta,Quentin Tarantino,154,Thriller,205928762
8000000,1411927,Andrew Garfield,Ramin Bahrani,112,Drama,-6588073
8000000,27362712,Sanaa Lathan,Rick Famuyiwa,109,Comedy,19362712
8000000,52287000,Wil Wheaton,Rob Reiner,89,Crime,44287000
8000000,21706101,Tim Robbins,Robert Altman,124,Comedy,13706101
8000000,106260000,Dustin Hoffman,Robert Benton,105,Drama,98260000
8000000,143451,James Marsden,Robert Moresco,107,Action,-7856549
8000000,11715321,Kurt Russell,Robert Zemeckis,113,Action,3715321
8000000,5634828,Glenn Close,Rodrigo Garc√≠a,113,Drama,-2365172
8000000,69821334,Tom Hanks,Ron Howard,111,Comedy,61821334
8000000,2033165,Ron Perlman,Simon Hunter,111,Action,-5966835
8000000,365134,Anthony Mackie,Spike Lee,138,Comedy,-7634866
8000000,22168359,Robert Englund,Stephen Hopkins,89,Horror,14168359
8000000,6739141,Christopher Lambert,Stuart Gordon,95,Action,-1260859
8000000,908847,Martin Henderson,Stuart Townsend,99,Action,-7091153
8000000,17460020,Dave Chappelle,Tamra Davis,82,Comedy,9460020
8000000,26049082,Zac Efron,Tom Gormican,94,Comedy,18049082
8000000,10629321,Sean Patrick Flanery,Troy Duffy,118,Action,2629321
8000000,74952305,Emma Stone,Will Gluck,92,Comedy,66952305
8000000,441306145,Linda Blair,William Friedkin,122,Drama,433306145
8000000,10600497,Woody Allen,Woody Allen,84,Comedy,2600497
8045760,35150960,Chevy Chase,Michael Ritchie,95,Comedy,27105200
8169363,8175346,Johnny Depp,John Badham,90,Crime,5983
8200000,80035402,Kevin Bacon,Herbert Ross,107,Drama,71835402
8200000,163214286,Julie Andrews,Robert Wise,174,Drama,155014286
8256269,460978,Ryan Reynolds,William Phillips,97,Action,-7795291
8376800,13000000,Hrithik Roshan,Ashutosh Gowariker,213,Action,4623200
8500000,70600000,Robert Redford,Alan J. Pakula,138,Drama,62100000
8500000,43528634,Mae Whitman,Ari Sandel,100,Romance,35028634
8500000,38697217,Jake Gyllenhaal,Dan Gilroy,117,Crime,30197217
8500000,68282844,Matt Lanter,Dave Filoni,98,Thriller,59782844
8500000,22456509,Paula Patton,David E. Talbert,96,Comedy,13956509
8500000,9747,James McAvoy,Eran Creevy,99,Action,-8490253
8500000,7500000,Samuel L. Jackson,Jalmari Helander,90,Action,-1000000
8500000,4440055,Abbie Cornish,Jane Campion,119,Drama,-4059945
8500000,5001655,Kevin Heffernan,Jay Chandrasekhar,104,Comedy,-3498345
8500000,32222567,Jason Patric,Joel Schumacher,97,Comedy,23722567
8500000,29916207,John Belushi,John G. Avildsen,94,Comedy,21416207
8500000,16209459,Arnold Schwarzenegger,John Irvin,106,Action,7709459
8500000,47624253,Wesley Snipes,Mario Van Peebles,97,Thriller,39124253
8500000,5480996,Keanu Reeves,Richard Linklater,100,Animation,-3019004
8500000,770706,Christoph Waltz,Terry Gilliam,107,Drama,-7729294
8500000,8936663,Tony Jaa,Tony Jaa,98,Adventure,436663
8900000,50136,Jeffrey Dean Morgan,Scott Mann,93,Crime,-8849864
9000000,7936012,Jon Voight,Andrei Konchalovsky,111,Action,-1063988
9000000,82391145,Liv Tyler,Bryan Bertino,90,Thriller,73391145
9000000,4777465,Kieran Culkin,Burr Steers,97,Comedy,-4222535
9000000,39723096,Guy Pearce,Christopher Nolan,113,Mystery,30723096
9000000,23936908,John Cho,Danny Leiner,88,Comedy,14936908
9000000,28607524,Gene Hackman,David Anspaugh,114,Drama,19607524
9000000,2955039,Jesse Lee Soffer,Davis Guggenheim,97,Drama,-6044961
9000000,2395231,Brad Pitt,Dominic Sena,117,Thriller,-6604769
9000000,41590886,Jada Pinkett Smith,F. Gary Gray,118,Drama,32590886
9000000,21510851,Katie Cassidy,Glen Morgan,84,Horror,12510851
9000000,4350774,Jeremy Piven,Hart Bochner,79,Comedy,-4649226
9000000,108782847,Frank Grillo,James DeMonaco,104,Horror,99782847
9000000,46236000,Clint Eastwood,James Fargo,96,Action,37236000
9000000,20518905,Dan Monahan,James Komack,92,Comedy,11518905
9000000,20458340,Val Kilmer,Jim Abrahams,90,Comedy,11458340
9000000,6153939,John Turturro,Joel Coen,116,Comedy,-2846061
9000000,18663238,Dianna Agron,Kevin Tancharoen,84,Documentary,9663238
9000000,34573780,Nia Long,Malcolm D. Lee,120,Drama,25573780
9000000,25000000,Michael York,Michael Anderson,120,Adventure,16000000
9000000,24538513,Michael Moore,Michael Moore,123,Documentary,15538513
9000000,21571189,Kevin Costner,Mike Binder,121,Drama,12571189
9000000,8303261,Robert Pattinson,Nick Ormerod,102,Drama,-696739
9000000,10404330,Chaim Topol,Norman Jewison,181,Drama,1404330
9000000,32973937,Michael Cera,Peter Sollett,89,Comedy,23973937
9000000,70000000,Aamir Khan,Rajkumar Hirani,170,Drama,61000000
9000000,985117,Susan Sarandon,Tim Blake Nelson,104,Comedy,-8014883
9000000,44196684,Catherine Hicks,Tom Holland,87,Horror,35196684
9000000,24922237,Chris Sarandon,Tom Holland,106,Horror,15922237
9000000,27105095,Jon Foster,William Brent Bell,100,Horror,18105095
9100000,76000000,Aamir Khan,A.R. Murugadoss,183,Action,66900000
9500000,14560247,Nicolas Cage,David Lynch,124,Comedy,5060247
9500000,120000,Clive Owen,David Schwimmer,104,Crime,-9380000
9500000,17164377,Jesse Eisenberg,Greg Mottola,107,Comedy,7664377
9500000,7800000,Jason Bateman,Jason Bateman,88,Comedy,-1700000
9500000,111584787,Sean Connery,Lewis Gilbert,117,Action,102084787
9500000,107071655,Jessica Biel,Marcus Nispel,98,Horror,97571655
9600000,4386236,Andy Garc√≠a,Andy Garc√≠a,144,Drama,-5213764
9600000,2541554,Robert Redford,James Vanderbilt,121,Drama,-7058446
10000000,3334927,Angelina Jolie,Angelina Jolie,122,Drama,-6665073
10000000,303877,Zana Marjanovi,Angelina Jolie,127,Drama,-9696123
10000000,30283,Benicio del Toro,Arnaud Desplechin,117,Drama,-9969717
10000000,55089,Rosanna Arquette,Baltasar Korm√°kur,100,Drama,-9944911
10000000,20342161,Lennie Loftin,Ben Garant,84,Action,10342161
10000000,6451628,Ian McKellen,Bill Condon,105,Drama,-3548372
10000000,1500000,Robert Stephens,Billy Wilder,125,Adventure,-8500000
10000000,295750,Robin Williams,Bobcat Goldthwait,99,Comedy,-9704250
10000000,1068682,Hayden Christensen,Brad Anderson,92,Drama,-8931318
10000000,32101000,Jeff Fahey,Brett Leonard,108,Horror,22101000
10000000,8801940,Craig Wasson,Brian De Palma,114,Mystery,-1198060
10000000,47410000,Steven Seagal,Bruce Malmuth,96,Action,37410000
10000000,16800000,Ron Moody,Carol Reed,153,Drama,6800000
10000000,1759252,Demi√°n Bichir,Chris Weitz,98,Drama,-8240748
10000000,22896728,Jay Chou,Chu Yen-ping,100,Action,12896728
10000000,44460850,Rickey D'Shon Collins,Chuck Sheetz,83,Animation,34460850
10000000,52882018,Shannyn Sossamon,Ciaran Foy,97,Horror,42882018
10000000,66821036,Eric Balfour,Colin Strause,100,Science Fiction,56821036
10000000,11411644,Catherine Cavadini,Craig McCracken,73,Action,1411644
10000000,10835752,Al Pacino,Dan Fogelman,107,Comedy,835752
10000000,163876815,Tobin Bell,Darren Lynn Bousman,108,Horror,153876815
10000000,139352633,Tobin Bell,Darren Lynn Bousman,93,Horror,129352633
10000000,25399945,Sean Bean,Dave Meyers,84,Action,15399945
10000000,20766616,Christopher Walken,David Cronenberg,103,Thriller,10766616
10000000,4160851,Sheryl Lee,David Lynch,125,Drama,-5839149
10000000,33000000,Simon Pegg,David Schwimmer,100,Comedy,23000000
10000000,7022728,David Duchovny,Derrick Borte,96,Comedy,-2977272
10000000,14356479,Brandon Lee,Dwight H. Little,95,Action,4356479
10000000,1631839,Sandra Bullock,Eric Blakeney,101,Action,-8368161
10000000,7316658,Snoop Dogg,Ernest R. Dickerson,96,Action,-2683342
10000000,2995811,Dakota Fanning,Floria Sigismondi,106,Drama,-7004189
10000000,25697647,Matt Dillon,Francis Ford Coppola,91,Crime,15697647
10000000,2494480,Matt Dillon,Francis Ford Coppola,94,Action,-7505520
10000000,91196419,Michael Keaton,Geoffrey Sax,101,Drama,81196419
10000000,100489151,Burt Lancaster,George Seaton,137,Action,90489151
10000000,78099553,Chris J. Murray,Gregory Plotkin,88,Horror,68099553
10000000,225933435,Robin Williams,Gus Van Sant,126,Drama,215933435
10000000,83557872,Jason Statham,Guy Ritchie,103,Thriller,73557872
10000000,598645,Madonna,Guy Ritchie,89,Comedy,-9401355
10000000,25605015,Jennifer Love Hewitt,Harry Elfont,100,Comedy,15605015
10000000,3428048,Jason Bateman,Henry Alex Rubin,115,Drama,-6571952
10000000,14333790,Sharlto Copley,Ilya Naishuller,97,Action,4333790
10000000,85300000,Bill Murray,Ivan Reitman,106,Action,75300000
10000000,5241315,Robert Downey Jr.,James Toback,98,Drama,-4758685
10000000,21587700,Matthew McConaughey,Jeff Nichols,130,Drama,11587700
10000000,17273593,Paul Rudd,Jesse Peretz,90,Comedy,7273593
10000000,19000000,Jay Mohr,Jim Abrahams,84,Comedy,9000000
10000000,45742101,Bill Murray,Jim Jarmusch,105,Comedy,35742101
10000000,23574130,Winona Ryder,Jocelyn Moorhouse,116,Drama,13574130
10000000,13782838,Kurt Russell,John Carpenter,109,Horror,3782838
10000000,498974,Lyndsy Fonseca,John Carpenter,88,Horror,-9501026
10000000,33583175,Chris Messina,John Erick Dowdle,80,Horror,23583175
10000000,4711220,Linda Hamilton,John Guillermin,105,Action,-5288780
10000000,31973249,David Naughton,John Landis,97,Horror,21973249
10000000,4349187,Simon Pegg,John Landis,91,Comedy,-5650813
10000000,136836156,Bill Nighy,John Madden,124,Drama,126836156
10000000,85978266,Dev Patel,John Madden,122,Drama,75978266
10000000,17500000,Meg Ryan,Jon Kasdan,97,Romance,7500000
10000000,21486757,Michelle Pfeiffer,Jonathan Demme,104,Action,11486757
10000000,6110000,Will Forte,Jorma Taccone,90,Action,-3890000
10000000,3916303,Geena Davis,Julien Temple,100,Music,-6083697
10000000,29392418,Keenen Ivory Wayans,Keenen Ivory Wayans,100,Action,19392418
10000000,30652890,Ben Affleck,Kevin Smith,130,Fantasy,20652890
10000000,17472,Nicole Kidman,Kim Farrant,111,Drama,-9982528
10000000,63647833,Gabourey Sidibe,Lee Daniels,110,Drama,53647833
10000000,104303851,Dermot Mulroney,Leigh Whannell,97,Drama,94303851
10000000,9636289,Steve Carell,Lorene Scafaria,101,Drama,-363711
10000000,4417580,Jason Segel,Mark Duplass,83,Drama,-5582420
10000000,57500000,Arnold Schwarzenegger,Mark L. Lester,90,Action,47500000
10000000,610986,Patrick Wilson,Matthew Chapman,101,Drama,-9389014
10000000,10571408,Kirsten Dunst,Michael Patrick Jann,98,Comedy,571408
10000000,25754284,Taimak,Michael Schultz,108,Action,15754284
10000000,12827813,Ron Livingston,Mike Judge,89,Comedy,2827813
10000000,26330482,Brenda Blethyn,Nigel Cole,93,Crime,16330482
10000000,96542059,Helen Mirren,Nigel Cole,108,Comedy,86542059
10000000,7587485,Ben Stiller,Noah Baumbach,97,Drama,-2412515
10000000,42333295,Milla Jovovich,Olatunde Osunsanmi,98,Science Fiction,32333295
10000000,653651,Zac Efron,Peter Landesman,94,History,-9346349
10000000,7825000,Nicole Kidman,Phillip Noyce,96,Crime,-2175000
10000000,54999651,Tom Hanks,Richard Benjamin,91,Comedy,44999651
10000000,17297244,Pierce Brosnan,Richard Shepard,96,Action,7297244
10000000,8359717,Jackie Chan,Ringo Lam,89,Action,-1640283
10000000,1585582,Amanda Seyfried,Rob Epstein,92,Drama,-8414418
10000000,103166989,Freddie Prinze Jr.,Robert Iscove,95,Comedy,93166989
10000000,86572238,Michael Douglas,Robert Zemeckis,106,Action,76572238
10000000,12008642,Cate Blanchett,Sam Raimi,111,Horror,2008642
10000000,1461989,Ai Kobayashi,Shinji Aramaki,101,Animation,-8538011
10000000,17979739,Johnny Yong Bosch,Shuki Levy,99,Action,7979739
10000000,16153593,Denzel Washington,Spike Lee,129,Drama,6153593
10000000,25196249,Christina Applegate,Stephen Herek,105,Comedy,15196249
10000000,50752337,Emilio Estevez,Stephen Herek,101,Comedy,40752337
10000000,40485039,Keanu Reeves,Stephen Herek,90,Adventure,30485039
10000000,7433663,Emilio Estevez,Stephen King,97,Action,-2566337
10000000,14000,Melanie Griffith,Steve De Jarnatt,99,Science Fiction,-9986000
10000000,3193102,Terence Stamp,Steven Soderbergh,89,Drama,-6806898
10000000,183474602,Sarah Michelle Gellar,Takashi Shimizu,92,Horror,173474602
10000000,26488734,Adam Sandler,Tamra Davis,89,Comedy,16488734
10000000,28883511,Amy Adams,Tim Burton,105,Drama,18883511
10000000,1034589,Ed Harris,Todd Robinson,99,Thriller,-8965411
10000000,31609243,Gabrielle Union,Tyler Perry,100,Comedy,21609243
10000000,59217789,Gina Philips,Victor Salva,90,Horror,49217789
10000000,5000000,Akshay Kumar,Vipul Amrutlal Shah,100,Drama,-5000000
10000000,15795189,David Carradine,Walter Hill,99,Western,5795189
10000000,7177143,Christian Bale,Werner Herzog,126,Adventure,-2822857
10000000,3665069,Matthew McConaughey,William Friedkin,102,Drama,-6334931
10000000,21786738,Norah Jones,Wong Kar-wai,111,Drama,11786738
10000000,10389003,Woody Allen,Woody Allen,89,Comedy,389003
10200000,35619521,Lauren German,Eli Roth,93,Horror,25419521
10284523,11588205,Steve Martin,Anand Tucker,104,Comedy,1303682
10500000,14144000,Tom Skerritt,Gary Sherman,98,Horror,3644000
10500000,11582891,David Andrews,Ralph S. Singleton,89,Drama,1082891
10500000,75902208,Sarah Michelle Gellar,Roger Kumble,97,Drama,65402208
10500000,792910554,Henry Thomas,Steven Spielberg,115,Science Fiction,782410554
10700000,122200000,JoBeth Williams,Tobe Hooper,114,Horror,111500000
10800000,113857533,Tobin Bell,David Hackl,92,Horror,103057533
10831173,10654385,Paul Giamatti,Tom McCarthy,106,Drama,-176788
10900000,16505460,Gugu Mbatha-Raw,Amma Asante,105,Drama,5605460
11000000,41227069,Mandy Moore,Adam Shankman,101,Drama,30227069
11000000,13110448,Bill Paxton,Bill Paxton,100,Drama,2110448
11000000,13196245,Chris Rock,Chris Rock,90,Comedy,2196245
11000000,8862354,Craig Sheffer,Clive Barker,102,Action,-2137646
11000000,1863315,Marie Avgeropoulos,Daniel Benmayor,94,Action,-9136685
11000000,49797148,Tom Berenger,David S. Ward,107,Comedy,38797148
11000000,3639345,Liam Hemsworth,Dito Montiel,94,Action,-7360655
11000000,59520298,Maggie Smith,Dustin Hoffman,98,Drama,48520298
11000000,13276953,Marla Sokoloff,Francine McDougall,81,Crime,2276953
11000000,775398007,Mark Hamill,George Lucas,121,Adventure,764398007
11000000,38105395,Dakota Fanning,Gina Prince-Bythewood,114,Adventure,27105395
11000000,23430766,Jerry O'Connell,Gregory Poirier,95,Comedy,12430766
11000000,16000000,Kane Hodder,James Isaac,91,Horror,5000000
11000000,72778712,Johnny Knoxville,Jeff Tremaine,95,Action,61778712
11000000,153083102,Zach Galligan,Joe Dante,106,Fantasy,142083102
11000000,32935319,Oscar Isaac,Joel Coen,105,Drama,21935319
11000000,62076141,Saoirse Ronan,John Crowley,111,Drama,51076141
11000000,8266343,Johnny Depp,John Waters,85,Music,-2733657
11000000,119418501,Kathy Bates,Jon Avnet,130,Drama,108418501
11000000,45967935,Jon Favreau,Jon Favreau,115,Comedy,34967935
11000000,64088552,Joe Pesci,Jonathan Lynn,120,Comedy,53088552
11000000,15500000,Bijou Phillips,Josef Rusnak,80,Horror,4500000
11000000,68233629,Tobin Bell,Kevin Greutert,90,Horror,57233629
11000000,791867,Willem Dafoe,Lars von Trier,108,Drama,-10208133
11000000,30000000,Johnny Depp,Lasse Hallstr√∂m,118,Romance,19000000
11000000,168000000,Tom Selleck,Leonard Nimoy,102,Family,157000000
11000000,31672907,Mel Brooks,Mel Brooks,92,Comedy,20672907
11000000,7847000,Daniel Radcliffe,Michael Dowse,93,Drama,-3153000
11000000,178104,John Candy,Michael Moore,91,Action,-10821896
11000000,235483004,Jason Biggs,Paul Weitz,95,Comedy,224483004
11000000,78874843,Chlo√´ Grace Moretz,R.J. Cutler,106,Drama,67874843
11000000,34872033,Robert Englund,Rachel Talalay,89,Horror,23872033
11000000,104931801,Sigourney Weaver,Ridley Scott,117,Horror,93931801
11000000,23978402,Chris Kattan,Rob Pritts,86,Action,12978402
11000000,48572000,Kevin Bacon,Ron Underwood,96,Action,37572000
11000000,46396427,Hrithik Roshan,Sanjay Gadhvi,147,Drama,35396427
11000000,61619773,Helen Mirren,Simon Curtis,120,Drama,50619773
11000000,20000000,Ryan O'Neal,Stanley Kubrick,184,Drama,9000000
11000000,59827328,Ice Cube,Steve Carr,98,Comedy,48827328
11000000,11439193,Denis Leary,Ted Demme,97,Comedy,439193
11000000,141195658,Sean Connery,Terence Young,130,Adventure,130195658
11000000,39363635,Susan Sarandon,Tim Robbins,122,Drama,28363635
11000000,32861136,Ming-Na Wen,Wayne Wang,139,Drama,21861136
11000000,2807854,Milla Jovovich,William A. Graham,98,Drama,-8192146
11000000,27391084,Emma Stone,Woody Allen,95,Mystery,16391084
11500000,20079850,Winona Ryder,Ben Stiller,99,Drama,8579850
11500000,69564,Mischa Barton,Brett Simon,93,Comedy,-11430436
11500000,23237911,Anthony Hopkins,James Ivory,134,Drama,11737911
11500000,1402307,Jean-Claude Van Damme,John Hyams,114,Thriller,-10097693
11500000,57469467,Dale Midkiff,Mary Lambert,103,Drama,45969467
11500000,186702,Kate Beckinsale,Rod Lurie,108,Drama,-11313298
11700000,88036683,Annabella Sciorra,Curtis Hanson,110,Drama,76336683
11800000,40272135,Cate Blanchett,Todd Haynes,118,Romance,28472135
11930000,18340000,Kate Winslet,Jocelyn Moorhouse,118,Drama,6410000
12000000,30036000,Meryl Streep,Alan J. Pakula,151,Drama,18036000
12000000,17654912,Bruce Dern,Alexander Payne,115,Drama,5654912
12000000,4000000,David Duchovny,Andy Wilson,94,Drama,-8000000
12000000,114194847,Channing Tatum,Anne Fletcher,104,Music,102194847
12000000,30400000,Barbra Streisand,Barbra Streisand,132,Music,18400000
12000000,36450736,Kathleen Turner,Bob Clark,97,Comedy,24450736
12000000,37170057,John Lithgow,Brian De Palma,91,Drama,25170057
12000000,42931041,Jason Statham,Brian Taylor,88,Action,30931041
12000000,12077441,Mia Wasikowska,Chan-wook Park,99,Drama,77441
12000000,9620399,Lindsay Lohan,Chris Sivertson,105,Crime,-2379601
12000000,15826984,Pat Morita,Christopher Cain,107,Adventure,3826984
12000000,31179516,Cedric the Entertainer,Christopher Erskin,97,Comedy,19179516
12000000,5542025,Catherine O'Hara,Christopher Guest,86,Comedy,-6457975
12000000,11293663,Ryan Gosling,Craig Gillespie,106,Comedy,-706337
12000000,32726956,Katy Perry,Dan Cutforth,93,Documentary,20726956
12000000,1456675,John Hawkes,Daniel Schechter,94,Comedy,-10543325
12000000,22750363,Sean Astin,David Anspaugh,114,Drama,10750363
12000000,21133087,Kevin Bacon,David Koepp,99,Horror,9133087
12000000,60273173,Michael Ealy,David M. Rosenthal,100,Drama,48273173
12000000,56309766,Jessica Alba,David Moreau,98,Drama,44309766
12000000,2521,Samuel L. Jackson,David Weaver,90,Thriller,-11997479
12000000,78756177,Leslie Nielsen,David Zucker,85,Action,66756177
12000000,32248241,Jonny Weston,Dean Israelite,106,Science Fiction,20248241
12000000,9622846,Eva Longoria,Dean Wright,145,Drama,-2377154
12000000,41205099,Adam Sandler,Dennis Dugan,92,Comedy,29205099
12000000,24829644,Brad Dourif,Don Mancini,87,Comedy,12829644
12000000,46044400,Steven Seagal,Dwight H. Little,94,Action,34044400
12000000,23006849,Emma Roberts,Elizabeth Allen Rosenbaum,104,Fantasy,11006849
12000000,21001563,Cher,Franco Zeffirelli,117,Comedy,9001563
12000000,89800000,George C. Scott,Franklin J. Schaffner,172,Drama,77800000
12000000,53267000,Steve McQueen,Franklin J. Schaffner,151,Crime,41267000
12000000,3769990,Andre Gower,Fred Dekker,82,Horror,-8230010
12000000,7070330,Ioan Gruffudd,G√°bor Csup√≥,103,Adventure,-4929670
12000000,38368909,Dane Cook,Greg Coolidge,103,Comedy,26368909
12000000,110996879,Michael J. Fox,Herbert Ross,111,Comedy,98996879
12000000,85512300,Nat Wolff,Jake Schreier,109,Drama,73512300
12000000,3148182,Joaquin Phoenix,James Gray,110,Drama,-8851818
12000000,22939027,Charlize Theron,Jason Reitman,94,Comedy,10939027
12000000,31155435,Method Man,Jesse Dylan,93,Comedy,19155435
12000000,79567667,Matthew Broderick,John Badham,114,Thriller,67567667
12000000,22921898,Matt Damon,John Dahl,121,Drama,10921898
12000000,40855419,Jennifer Carpenter,John Erick Dowdle,89,Horror,28855419
12000000,15942628,Patrick Swayze,John Irvin,108,Adventure,3942628
12000000,43493123,John Cho,Jon Hurwitz,107,Comedy,31493123
12000000,305151265,Shailene Woodley,Josh Boone,125,Romance,293151265
12000000,35931410,Ashton Kutcher,Joshua Michael Stern,128,Drama,23931410
12000000,56298474,Salma Hayek,Julie Taymor,123,Drama,44298474
12000000,27400000,Christina Ricci,Lesli Linka Glatter,100,Comedy,15400000
12000000,204940,Keanu Reeves,Malcolm Venville,108,Action,-11795060
12000000,1381665,Alan Rickman,Marc Evans,112,Romance,-10618335
12000000,15945534,John Candy,Mark L. Lester,88,Action,3945534
12000000,52223306,Robin Williams,Mark Romanek,96,Horror,40223306
12000000,81272766,Roselyn S√°nchez,Mike McCoy,110,Action,69272766
12000000,20138836,Kal Penn,Mira Nair,122,Drama,8138836
12000000,1644755,Colin Farrell,Neil Jordan,111,Drama,-10355245
12000000,6814789,Michael Fassbender,Neil Marshall,97,Drama,-5185211
12000000,35485056,Richard Gere,Nicholas Jarecki,100,Drama,23485056
12000000,96800000,William Shatner,Nicholas Meyer,113,Science Fiction,84800000
12000000,100000000,Oliver Cooper,Nima Nourizadeh,88,Comedy,88000000
12000000,972512,Woody Harrelson,Oren Moverman,108,Crime,-11027488
12000000,68706993,Harrison Ford,Peter Weir,113,Crime,56706993
12000000,84967,Josh Hartnett,Petter N√¶ss,92,Comedy,-11915033
12000000,9584131,David Belle,Pierre Morel,84,Action,-2415869
12000000,39673162,Pam Grier,Quentin Tarantino,154,Action,27673162
12000000,101332962,Greg Kinnear,Randall Wallace,99,Drama,89332962
12000000,4922166,Kelly Clarkson,Robert Iscove,90,Comedy,-7077834
12000000,15008161,Danny Trejo,Robert Rodriguez,107,Action,3008161
12000000,20000000,Steve McQueen,Robert Wise,182,Action,8000000
12000000,6754898,Annette Bening,Ryan Murphy,116,Drama,-5245102
12000000,22765081,Kris Kristofferson,Sam Peckinpah,110,Action,10765081
12000000,56715371,Keir Dullea,Stanley Kubrick,149,Science Fiction,44715371
12000000,60000000,Kirk Douglas,Stanley Kubrick,197,Action,48000000
12000000,66351,Eric Bana,Stefan Ruzowitzky,95,Crime,-11933649
12000000,100129872,Judi Dench,Stephen Frears,98,Drama,88129872
12000000,5285197,Blake Woodruff,Stewart Hendler,94,Crime,-6714803
12000000,40716963,Paul Newman,Sydney Pollack,116,Drama,28716963
12000000,61141030,Britney Spears,Tamra Davis,93,Action,49141030
12000000,29800000,Mickey Rooney,Ted Berman,82,Adventure,17800000
12000000,17292381,Alex D. Linz,Tim Hill,86,Comedy,5292381
12000000,75781642,Ice Cube,Tim Story,102,Comedy,63781642
12000000,96070507,Michael Ealy,Tim Story,123,Comedy,84070507
12000000,4884663,Karen Black,Tobe Hooper,100,Science Fiction,-7115337
12000000,10289,Jason Statham,Tony Giglio,106,Drama,-11989711
12250000,2295423,Guy Pearce,David Mich√¥d,100,Crime,-9954577
12300000,84460846,Gabriel Damon,Don Bluth,69,Animation,72160846
12305523,36230219,Mel Gibson,George Miller,107,Action,23924696
12468389,29007412,Rebel Wilson,Stephan Elliott,97,Comedy,16539023
12500000,23367586,Derek Luke,Denzel Washington,120,Drama,10867586
12500000,75993061,Ryan Gosling,George Clooney,101,Drama,63493061
12500000,1083683,Kevin Spacey,George Hickenlooper,108,Crime,-11416317
12500000,238227,Richard Chamberlain,J. Lee Thompson,100,Action,-12261773
12500000,10725228,Al Pacino,James Foley,100,Crime,-1774772
12500000,1353868,Zac Efron,Lee Daniels,107,Thriller,-11146132
12500000,20416563,Vera Farmiga,Mark Herman,94,War,7916563
12500000,49002684,Kevin Hart,Steve Pink,100,Comedy,36502684
12500000,27206120,Rumer Willis,Stewart Hendler,101,Horror,14706120
12500000,6732980,Hilary Swank,Tony Goldwyn,107,Drama,-5767020
12500000,12281551,Christian Slater,Tony Scott,120,Action,-218449
12500000,3878993,"Clifton Collins, Jr.",William Dear,118,Drama,-8621007
12600000,18658381,Tom Hardy,Micha√´l R. Roskam,106,Drama,6058381
12600000,28650575,Desmond Harrington,Rob Schmidt,84,Horror,16050575
12700000,3430018,Brendan Gleeson,Don McKellar,112,Comedy,-9269982
12800000,40031879,Bj√∂rk,Lars von Trier,140,Drama,27231879
13000000,428868,Gabrielle Anwar,Abel Ferrara,87,Horror,-12571132
13000000,27500000,Kirsten Dunst,Andrew Fleming,94,Comedy,14500000
13000000,123922370,Robin Williams,Barry Levinson,121,Comedy,110922370
13000000,68572378,Halle Berry,Brad Anderson,94,Thriller,55572378
13000000,23727301,Romain Duris,C√©dric Klapisch,129,Comedy,10727301
13000000,73180723,Ashton Kutcher,Danny Leiner,83,Comedy,60180723
13000000,327803731,Natalie Portman,Darren Aronofsky,108,Drama,314803731
13000000,45300000,Teo Halm,Dave Green,89,Family,32300000
13000000,8038508,Jeremy Irons,David Cronenberg,115,Drama,-4961492
13000000,1151330,Sigourney Weaver,Douglas McGrath,110,Drama,-11848670
13000000,96060858,Ashton Kutcher,Eric Bress,113,Science Fiction,83060858
13000000,47542841,Al Pacino,Francis Ford Coppola,200,Drama,34542841
13000000,754249,Nathaniel Brown,Gaspar No√©,161,Fantasy,-12245751
13000000,32848185,Helen Mirren,Gavin Hood,102,Drama,19848185
13000000,10652035,Jim Carrey,Glenn Ficarra,98,Comedy,-2347965
13000000,14894347,Pen√©lope Cruz,Isabel Coixet,112,Drama,1894347
13000000,20560255,Justin Whalin,Jack Bender,90,Horror,7560255
13000000,17040871,Bill Paxton,James Cameron,92,Family,4040871
13000000,318000141,Patrick Wilson,James Wan,112,Horror,305000141
13000000,65796862,Daniel Day-Lewis,Jim Sheridan,133,Drama,52796862
13000000,97837138,Colin Farrell,Joel Schumacher,81,Thriller,84837138
13000000,35763605,Alex Vincent,John Lafia,84,Drama,22763605
13000000,4619014,Jerry O'Connell,John Payson,78,Fantasy,-8380986
13000000,16929123,Kirsten Dunst,John Stockwell,99,Drama,3929123
13000000,7820688,Kathleen Turner,John Waters,95,Crime,-5179312
13000000,98441954,Justin Bieber,Jon M. Chu,105,Documentary,85441954
13000000,8946237,Helen Mirren,Kevin Williamson,96,Comedy,-4053763
13000000,27007143,Mark Wahlberg,Kirk Wong,91,Action,14007143
13000000,1646788,Tom Hiddleston,Marc Abraham,123,Drama,-11353212
13000000,16757163,Ryan Phillippe,Mark Christopher,93,Music,3757163
13000000,1784763,Olivia Taylor Dudley,Mark Neveldine,91,Thriller,-11215237
13000000,11130889,Billy Bob Thornton,Michael Polish,104,Adventure,-1869111
13000000,53000000,Peter Weller,Paul Verhoeven,102,Action,40000000
13000000,18000000,Tina Fey,Paul Weitz,107,Comedy,5000000
13000000,114956699,Meryl Streep,Phyllida Lloyd,105,History,101956699
13000000,37664855,Jamie Lee Curtis,Rick Rosenthal,94,Horror,24664855
13000000,48065672,Miles Teller,Scott Moore,93,Comedy,35065672
13000000,18295,Pen√©lope Cruz,Sergio Castellitto,127,Drama,-12981705
13000000,22863596,John Cusack,Spike Jonze,112,Fantasy,9863596
13000000,33400000,Logan Lerman,Stephen Chbosky,102,Drama,20400000
13000000,3752426,Kristy Swanson,Stewart Raffill,95,Fantasy,-9247574
13000000,75511123,Columbus Short,Sylvain White,114,Drama,62511123
13000000,54837234,Bill Murray,Theodore Melfi,102,Comedy,41837234
13000000,91038276,Julia Stiles,Thomas Carter,112,Drama,78038276
13000000,17917287,Vincent P√©rez,Tim Pope,84,Action,4917287
13200000,15171476,Maxwell Caulfield,Patricia Birch,115,Comedy,1971476
13200000,53830415,Idris Elba,Sam Miller,84,Thriller,40630415
13300000,5380251,Scarlett Johansson,Jonathan Glazer,108,Thriller,-7919749
13500000,19255873,Geoffrey Rush,Giuseppe Tornatore,124,Drama,5755873
13500000,7060876,Geoffrey Rush,Philip Kaufman,124,Drama,-6439124
13500000,187674,Jeremy Irvine,Roland Emmerich,129,Drama,-13312326
13500000,201965915,Judith Hoag,Steve Barron,93,Science Fiction,188465915
13500000,29027914,Julianne Moore,Todd Haynes,107,Drama,15527914
13500000,11285588,Woody Allen,Woody Allen,104,Comedy,-2214412
13800000,27100027,Burt Reynolds,Don Bluth,89,Drama,13300027
13800000,52293982,Paul Newman,Martin Scorsese,119,Drama,38493982
14000000,320145693,Michael Douglas,Adrian Lyne,119,Horror,306145693
14000000,178043761,Heath Ledger,Ang Lee,134,Drama,164043761
14000000,159157447,Clint Eastwood,Clint Eastwood,131,Western,145157447
14000000,57915972,Danny DeVito,Danny DeVito,88,Crime,43915972
14000000,111721910,Omar Sharif,David Lean,197,Drama,97721910
14000000,13015688,Alain Delon,David Lowell Rich,123,Action,-984312
14000000,22852638,Milla Jovovich,David Twohy,98,Thriller,8852638
14000000,5108820,Joshua Jackson,Davis Guggenheim,90,Drama,-8891180
14000000,6413915,Jason Segel,Dewey Nicks,86,Comedy,-7586085
14000000,463000000,Julia Roberts,Garry Marshall,119,Romance,449000000
14000000,35856053,George C. Scott,Harold Becker,126,Drama,21856053
14000000,72527595,Alicia Witt,Jamie Blanks,99,Horror,58527595
14000000,5080409,Gabriel Byrne,Joel Coen,115,Drama,-8919591
14000000,30749142,Linda Blair,John Boorman,118,Horror,16749142
14000000,39673161,Steven Seagal,John Flynn,91,Action,25673161
14000000,116000000,Steve McQueen,John Guillermin,159,Action,102000000
14000000,875386,Jean-Claude Van Damme,John Hyams,97,Adventure,-13124614
14000000,38574362,Jennifer Morrison,John Ottman,97,Horror,24574362
14000000,27515786,Janet Jackson,John Singleton,109,Drama,13515786
14000000,154864401,Leon Robinson,Jon Turteltaub,98,Comedy,140864401
14000000,11417362,Victoria Justice,Josh Schwartz,87,Comedy,-2582638
14000000,46495,Anna Paquin,Kenneth Lonergan,149,Drama,-13953505
14000000,25482931,Ice Cube,Kevin Bray,95,Action,11482931
14000000,185438673,Roger Moore,Lewis Gilbert,125,Adventure,171438673
14000000,10424470,Monica Potter,Mark Waters,86,Comedy,-3575530
14000000,233555708,Benedict Cumberbatch,Morten Tyldum,113,History,219555708
14000000,85446075,Jeffrey Dean Morgan,Ole Bornedal,92,Horror,71446075
14000000,18535191,Cate Blanchett,Oliver Parker,97,Drama,4535191
14000000,161001698,Tom Cruise,Oliver Stone,145,Drama,147001698
14000000,62134225,Nick Nolte,Paul Mazursky,103,Comedy,48134225
14000000,34793160,Klaus Maria Brandauer,Randal Kleiser,107,Action,20793160
14000000,21409028,Forest Whitaker,Rick Famuyiwa,103,Comedy,7409028
14000000,63513743,Jason Scott Lee,Rob Cohen,120,Drama,49513743
14000000,1755212,Madeline Carroll,Rob Reiner,90,Comedy,-12244788
14000000,13551174,Sigourney Weaver,Rodrigo Cort√©s,119,Thriller,-448826
14000000,24637469,Whitney Houston,Salim Akil,116,Drama,10637469
14000000,16002420,Carey Mulligan,Sarah Gavron,106,Drama,2002420
14000000,6856989,Richard Gere,Scott McGehee,104,Drama,-7143011
14000000,32482682,Spike Lee,Spike Lee,132,Drama,18482682
14000000,34670720,Glenn Close,Stephen Frears,119,Drama,20670720
14000000,12314651,Rob Corddry,Steve Pink,93,Comedy,-1685349
14000000,32645546,Jeff Daniels,Wayne Wang,106,Comedy,18645546
14000000,173046663,David Arquette,Wes Craven,111,Crime,159046663
14000000,19800000,Eddie Murphy,Wes Craven,100,Comedy,5800000
14000000,18090181,Heather Langenkamp,Wes Craven,112,Horror,4090181
14000000,2735731,Woody Allen,Woody Allen,85,Thriller,-11264269
14200000,674918,Bryce Dallas Howard,Lars von Trier,139,Drama,-13525082
14350531,3964682,Nick Frost,Joe Cornish,88,Action,-10385849
14400000,34700291,Sam Waterston,Roland Joff√©,141,War,20300291
14500000,147298761,Leonardo DiCaprio,Baz Luhrmann,120,Drama,132798761
14500000,22963701,Jamel Debbouze,Rachid Bouchareb,128,Drama,8463701
14500000,8089290,Michael Par√©,Walter Hill,93,Action,-6410710
14600000,70906973,Bill Murray,Harold Ramis,101,Romance,56306973
14800000,122413057,Channing Tatum,Gregory Jacobs,115,Comedy,107613057
15000000,34604000,Gene Hackman,Alan Parker,128,Thriller,19604000
15000000,109000000,Patrick Stewart,Alastair Fothergill,90,Documentary,94000000
15000000,36869414,Domhnall Gleeson,Alex Garland,108,Drama,21869414
15000000,94000000,Brandon Lee,Alex Proyas,102,Fantasy,79000000
15000000,69623713,Aaron Stanford,Alexandre Aja,107,Horror,54623713
15000000,37930465,Brad Pitt,Andrew Dominik,97,Crime,22930465
15000000,24769466,Fairuza Balk,Andrew Fleming,101,Fantasy,9769466
15000000,146497771,Jessica Chastain,Andy Muschietti,100,Horror,131497771
15000000,31554855,Philip Seymour Hoffman,Anton Corbijn,121,Thriller,16554855
15000000,31559552,Dustin Hoffman,Arthur Penn,139,Action,16559552
15000000,11992014,Adam Scott,Asif Kapadia,85,Drama,-3007986
15000000,8459458,Julianne Moore,Atom Egoyan,96,Drama,-6540542
15000000,3020664,Bill Murray,Barry Levinson,100,Comedy,-11979336
15000000,64256513,Dustin Hoffman,Barry Levinson,97,Comedy,49256513
15000000,15121165,Michael Pitt,Bernardo Bertolucci,115,Drama,121165
15000000,5926410,Woody Harrelson,Brad Anderson,111,Thriller,-9073590
15000000,12000000,Barry Pepper,Brian Koppelman,92,Crime,-3000000
15000000,5024782,Michael Douglas,Brian Koppelman,90,Comedy,-9975218
15000000,66000000,Jason David Frank,Bryan Spicer,92,Action,51000000
15000000,14860766,Tye Sheridan,Christopher B. Landon,93,Comedy,-139234
15000000,47175038,Debra Messing,Clare Kilner,88,Comedy,32175038
15000000,42724017,Clint Eastwood,Clint Eastwood,130,Action,27724017
15000000,51053787,Anne Hathaway,Cory Edwards,80,Animation,36053787
15000000,10903846,Samuel L. Jackson,Craig Brewer,116,Drama,-4096154
15000000,377910544,Dev Patel,Danny Boyle,120,Drama,362910544
15000000,60629159,Jeff Goldblum,David Cronenberg,96,Horror,45629159
15000000,2856712,Jennifer Jason Leigh,David Cronenberg,97,Action,-12143288
15000000,27462041,Keira Knightley,David Cronenberg,99,Drama,12462041
15000000,70000000,Peter O'Toole,David Lean,216,Adventure,55000000
15000000,3675201,Bill Pullman,David Lynch,134,Drama,-11324799
15000000,20117339,Naomi Watts,David Lynch,147,Thriller,5117339
15000000,17507368,James Marsden,David Nutter,82,Horror,2507368
15000000,9902115,Jodi Lyn O'Keefe,David Raynr,94,Drama,-5097885
15000000,21032267,Sally Field,David Seltzer,123,Comedy,6032267
15000000,10443316,Drew Barrymore,Dean Parisot,93,Drama,-4556684
15000000,30226144,Denzel Washington,Denzel Washington,126,Drama,15226144
15000000,35485608,Ryan Gosling,Derek Cianfrance,140,Drama,20485608
15000000,41092328,Laurence Olivier,Desmond Davis,118,Adventure,26092328
15000000,163169,Naomi Watts,Dick Maas,111,Action,-14836831
15000000,10219460,Christopher Walken,Douglas Trumbull,106,Science Fiction,-4780540
15000000,16633035,Ellen Page,Drew Barrymore,111,Drama,1633035
15000000,113221,Vincent Gallo,Francis Ford Coppola,127,Drama,-14886779
15000000,40590000,Nick Nolte,Francis Veber,96,Comedy,25590000
15000000,6908797,Meryl Streep,Fred Schepisi,120,Drama,-8091203
15000000,46770602,Simon Baker,George A. Romero,93,Horror,31770602
15000000,10611160,Timothy Hutton,George A. Romero,122,Mystery,-4388840
15000000,8138788,Matt Damon,Gus Van Sant,106,Drama,-6861212
15000000,61399552,Chevy Chase,Harold Ramis,98,Comedy,46399552
15000000,12308521,Robin Williams,Harold Ramis,96,Comedy,-2691479
15000000,201957688,Arnold Schwarzenegger,Ivan Reitman,111,Comedy,186957688
15000000,216614388,Arnold Schwarzenegger,Ivan Reitman,107,Comedy,201614388
15000000,20380,Pen√©lope Cruz,Jake Paltrow,93,Comedy,-14979620
15000000,44862187,Sylvester Stallone,James Mangold,104,Action,29862187
15000000,121201940,Eddie Redmayne,James Marsh,123,Drama,106201940
15000000,13290368,Molly Ringwald,James Toback,81,Romance,-1709632
15000000,8235661,Bryan Cranston,Jay Roach,124,Drama,-6764339
15000000,52501541,Reese Witherspoon,Jean-Marc Vall√©e,115,Drama,37501541
15000000,151831537,Johnny Knoxville,Jeff Tremaine,92,Comedy,136831537
15000000,40577001,Jim Henson,Jim Henson,93,Fantasy,25577001
15000000,27739163,Jeff Bridges,Joel Coen,117,Comedy,12739163
15000000,79258538,John Candy,John Hughes,100,Comedy,64258538
15000000,1914166,Tracey Ullman,John Waters,89,Comedy,-13085834
15000000,4882577,Ben Affleck,John Wells,104,Drama,-10117423
15000000,30238577,Beyonc√© Knowles,Jonathan Lynn,122,Comedy,15238577
15000000,14643997,Eileen Brennan,Jonathan Lynn,94,Comedy,-356003
15000000,145000000,Dane DeHaan,Josh Trank,84,Science Fiction,130000000
15000000,64238440,Imogen Poots,Juan Carlos Fresnadillo,100,Horror,49238440
15000000,42000000,Jeremy Renner,Kathryn Bigelow,131,Drama,27000000
15000000,19853892,William Hurt,Ken Russell,102,Mystery,4853892
15000000,44065653,Wesley Snipes,Kevin Hooks,84,Action,29065653
15000000,16500000,Peter Strauss,Lamont Johnson,90,Adventure,1500000
15000000,59389433,Anne Hathaway,Lone Scherfig,107,Drama,44389433
15000000,868439,Abbie Cornish,Madonna,119,Drama,-14131561
15000000,9455232,Carey Mulligan,Mark Romanek,104,Drama,-5544768
15000000,316360478,Eddie Murphy,Martin Brest,105,Action,301360478
15000000,32002538,Colin Farrell,Martin McDonagh,107,Comedy,17002538
15000000,19422261,Colin Farrell,Martin McDonagh,110,Comedy,4422261
15000000,5217498,Susan Ward,Mary Lambert,105,Thriller,-9782502
15000000,50000000,Robert De Niro,Michael Cimino,183,Drama,35000000
15000000,61548707,Adam Scott,Michael Dougherty,98,Horror,46548707
15000000,7938872,Naomi Watts,Michael Haneke,112,Horror,-7061128
15000000,8620929,William Petersen,Michael Mann,119,Crime,-6379071
15000000,21000000,Tim McGraw,Michael Mayer,95,Drama,6000000
15000000,133432856,Jean Dujardin,Michel Hazanavicius,100,Drama,118432856
15000000,46905889,Jennifer Aniston,Nicholas Hytner,111,Comedy,31905889
15000000,28733290,Lance Guest,Nick Castle,101,Adventure,13733290
15000000,76175166,Ryan Gosling,Nicolas Winding Refn,100,Drama,61175166
15000000,21766271,Naomi Watts,Oliver Hirschbiegel,113,Drama,6766271
15000000,43848069,Charlie Sheen,Oliver Stone,126,Crime,28848069
15000000,8786375,Cyril Raffaelli,Patrick Alessandrin,101,Action,-6213625
15000000,100734718,Jensen Ackles,Patrick Lussier,101,Mystery,85734718
15000000,76286096,J.J. Johnson,Paul Greengrass,111,Drama,61286096
15000000,4627375,Taylor Schilling,Paul Johansson,97,Drama,-10372625
15000000,43101594,Mark Wahlberg,Paul Thomas Anderson,155,Drama,28101594
15000000,8762890,Rainn Wilson,Peter Cattaneo,102,Comedy,-6237110
15000000,40105542,Sandra Bullock,Phil Traill,99,Comedy,25105542
15000000,120207127,Mel Gibson,Richard Donner,110,Adventure,105207127
15000000,49469904,Judi Dench,Richard Eyre,92,Drama,34469904
15000000,1143856,Romola Garai,Richard Eyre,90,Drama,-13856144
15000000,35007180,Joshua Jackson,Rob Cohen,106,Crime,20007180
15000000,80253908,Malcolm McDowell,Rob Zombie,109,Horror,65253908
15000000,39421467,Scout Taylor-Compton,Rob Zombie,105,Horror,24421467
15000000,11300653,Marcello Mastroianni,Robert Altman,133,Drama,-3699347
15000000,2281585,Neve Campbell,Robert Altman,112,Drama,-12718415
15000000,40283321,Jordana Brewster,Robert Rodriguez,104,Horror,25283321
15000000,118243066,Charles Grodin,Rod Daniel,89,Family,103243066
15000000,35509515,Kevin Costner,Roger Donaldson,114,Crime,20509515
15000000,32556119,Pierce Brosnan,Roger Donaldson,108,Crime,17556119
15000000,9237470,Kurt Russell,Ron Shelton,118,Action,-5762530
15000000,30050028,Patrick Swayze,Rowdy Herrington,114,Action,15050028
15000000,76382,Dolph Lundgren,Russell Mulcahy,93,Drama,-14923618
15000000,3533227,Bradley Cooper,Ry√ªhei Kitamura,98,Mystery,-11466773
15000000,15608545,Russell Crowe,RZA,96,Action,608545
15000000,356296601,Kevin Spacey,Sam Mendes,122,Drama,341296601
15000000,29331068,Lindsay Lohan,Sara Sugarman,89,Music,14331068
15000000,9104716,Michelle Williams,Saul Dibb,107,Drama,-5895284
15000000,14867514,Hilary Duff,Sean McNamara,103,Music,-132486
15000000,56255142,Emile Hirsch,Sean Penn,148,Adventure,41255142
15000000,20529194,Gwyneth Paltrow,Shana Feste,117,Drama,5529194
15000000,15785148,Robert Downey Jr.,Shane Black,103,Action,785148
15000000,52970014,Frankie Muniz,Shawn Levy,88,Comedy,37970014
15000000,30102717,Jean-Claude Van Damme,Sheldon Lettich,110,Thriller,15102717
15000000,66966987,Camilla Belle,Simon West,87,Horror,51966987
15000000,19145732,Emma Watson,Sofia Coppola,90,Drama,4145732
15000000,13060843,Edward Norton,Spike Lee,135,Crime,-1939157
15000000,123384128,Helen Mirren,Stephen Frears,103,Drama,108384128
15000000,59209,Elizabeth Banks,Steven Brill,95,Comedy,-14940791
15000000,146292009,Whoopi Goldberg,Steven Spielberg,154,Drama,131292009
15000000,125212904,Sylvester Stallone,Ted Kotcheff,93,Action,110212904
15000000,30127963,Jim Caviezel,Thomas Carter,115,Drama,15127963
15000000,75700498,Zachary Gordon,Thor Freudenthal,94,Comedy,60700498
15000000,73326666,Geena Davis,Tim Burton,92,Fantasy,58326666
15000000,414211549,Colin Firth,Tom Hooper,118,Drama,399211549
15000000,64191523,Eddie Redmayne,Tom Hooper,120,Drama,49191523
15000000,107217396,Jim Carrey,Tom Shadyac,86,Comedy,92217396
15000000,12036149,Tommy Lee Jones,Tommy Lee Jones,121,Adventure,-2963851
15000000,356830601,Tom Cruise,Tony Scott,110,Drama,341830601
15000000,55184721,Tyler Perry,Tyler Perry,113,Comedy,40184721
15000000,317000,William Hurt,Udayan Prasad,102,Drama,-14683000
15000000,6405245,Alexis Bledel,Vicky Jenson,89,Comedy,-8594755
15000000,9500000,Paul Walker,Wayne Kramer,122,Action,-5500000
15000000,32056467,Brian Bedford,Wolfgang Reitherman,83,Animation,17056467
15000000,85306374,Jonathan Rhys Meyers,Woody Allen,124,Drama,70306374
15000000,10631333,Mia Farrow,Woody Allen,82,Fantasy,-4368667
15000000,96408652,Scarlett Johansson,Woody Allen,96,Drama,81408652
15000000,6700000,Woody Allen,Woody Allen,95,Comedy,-8300000
15500000,7385434,Kevin Zegers,Nick Hurran,95,Comedy,-8114566
15774948,741875,Jason Statham,Elliott Lester,97,Crime,-15033073
16000000,12434778,Chris Pine,Alex Kurtzman,114,Drama,-3565222
16000000,109502303,Paul Giamatti,Alexander Payne,126,Comedy,93502303
16000000,318982,Naomi Watts,Anne Fontaine,100,Drama,-15681018
16000000,48017402,Bridget Fonda,Barbet Schroeder,107,Thriller,32017402
16000000,40492759,Minka Kelly,Christian E. Christiansen,91,Thriller,24492759
16000000,1109660,Kristen Stewart,Danny Pang,90,Thriller,-14890340
16000000,76514050,Odette Annable,David S. Goyer,87,Horror,60514050
16000000,50007546,Cloris Leachman,Diane English,114,Comedy,34007546
16000000,34786960,Hanyu Zhang,Feng Xiaogang,124,Action,18786960
16000000,81452156,Whitney Houston,Forest Whitaker,127,Comedy,65452156
16000000,53478166,Julia Stiles,Gil Junger,97,Comedy,37478166
16000000,5867686,Jeremy Renner,James Gray,120,Drama,-10132314
16000000,14822346,Tom Arnold,Jessy Terrero,86,Comedy,-1177654
16000000,66468332,Chyler Leigh,Joel Gallen,89,Comedy,50468332
16000000,29381649,Tyrese Gibson,John Singleton,130,Drama,13381649
16000000,18564088,Craig Bierko,Josef Rusnak,100,Thriller,2564088
16000000,4192440,Dolph Lundgren,Joseph Zito,105,Action,-11807560
16000000,31556061,Megan Fox,Karyn Kusama,100,Comedy,15556061
16000000,109130,Sean Penn,Kathryn Bigelow,113,Crime,-15890870
16000000,1686429,Shaquille O'Neal,Kenneth Johnson,97,Science Fiction,-14313571
16000000,47801389,Richard Gere,Lasse Hallstr√∂m,93,Drama,31801389
16000000,18928871,Angelina Jolie,Michael Winterbottom,100,Drama,2928871
16000000,15427192,Danny DeVito,Nick Gomez,96,Comedy,-572808
16000000,17374595,Sean Connery,Peter Hyams,112,Science Fiction,1374595
16000000,45361000,Susan Sarandon,Ridley Scott,130,Drama,29361000
16000000,30857814,Cary Elwes,Rob Reiner,98,Adventure,14857814
16000000,92823546,Meg Ryan,Rob Reiner,96,Comedy,76823546
16000000,20627372,Freddie Prinze Jr.,Robert Iscove,94,Comedy,4627372
16000000,5900000,Christopher Lambert,Russell Mulcahy,116,Adventure,-10100000
16000000,48878502,Liam Neeson,Sam Raimi,96,Action,32878502
16000000,5367030,Joseph Gordon-Levitt,Scott Frank,99,Crime,-10632970
16000000,53977250,Paul Newman,Sidney Lumet,129,Drama,37977250
16000000,2849142,Halle Berry,Susanne Bier,113,Drama,-13150858
16000000,119754278,Breckin Meyer,Todd Phillips,93,Comedy,103754278
16000000,2429989,Hilary Swank,Tommy Lee Jones,122,Western,-13570011
16000000,19682924,Nicolas Cage,Vic Armstrong,110,Thriller,3682924
16000000,68263166,Bruce Willis,Wes Anderson,94,Comedy,52263166
16000000,24377151,Owen Wilson,Wes Anderson,91,Adventure,8377151
16400000,235860116,Robin Williams,Peter Weir,129,Drama,219460116
16500000,135000000,Kate Winslet,Ang Lee,136,Drama,118500000
16500000,67683989,Mike Myers,Jay Roach,94,Science Fiction,51183989
16500000,13620075,Amanda Bynes,Joe Nussbaum,108,Comedy,-2879925
16500000,37311672,Anne Hathaway,Julian Jarrold,120,Drama,20811672
16500000,16942795,Jennifer Connelly,Vadim Perelman,126,Drama,442795
16800000,2281089,Nicole Kidman,Steven Shainberg,122,Drama,-14518911
17000000,6735922,Mickey Rourke,Adrian Lyne,117,Drama,-10264078
17000000,17185632,Mickey Rourke,Alan Parker,113,Horror,185632
17000000,209947037,Nicole Kidman,Alejandro Amen√°bar,101,Horror,192947037
17000000,29536299,Richard Gere,Antoine Fuqua,133,Crime,12536299
17000000,24922237,Anton Yelchin,Craig Gillespie,106,Horror,7922237
17000000,43165571,Alex Pettyfer,Daniel Barnz,86,Drama,26165571
17000000,20455276,Nia Vardalos,Donald Petrie,95,Comedy,3455276
17000000,97542952,Jane Levy,Fede Alvarez,91,Horror,80542952
17000000,72000000,Audrey Hepburn,George Cukor,170,Drama,55000000
17000000,29789000,Kevin Sorbo,Harold Cronk,113,Drama,12789000
17000000,127730736,Daniel Radcliffe,James Watkins,95,Drama,110730736
17000000,115350426,Anna Kendrick,Jason Moore,112,Comedy,98350426
17000000,24000000,Steve Martin,Jessie Nelson,107,Family,7000000
17000000,55534455,Hilary Duff,Jim Fall,94,Comedy,38534455
17000000,125586134,Jennifer Love Hewitt,Jim Gillespie,100,Horror,108586134
17000000,57103895,Ryan Reynolds,Joe Carnahan,109,Action,40103895
17000000,1569918,Cate Blanchett,Joel Schumacher,98,Drama,-15430082
17000000,30331165,Will Ferrell,John Fortenberry,81,Comedy,13331165
17000000,182057016,Sandra Bullock,Jon Turteltaub,103,Comedy,165057016
17000000,44456478,Macaulay Culkin,Joseph Ruben,87,Drama,27456478
17000000,136621271,Jake Johnson,Luke Greenfield,104,Comedy,119621271
17000000,71625195,Terrence Howard,Malcolm D. Lee,123,Comedy,54625195
17000000,129042871,Lindsay Lohan,Mark Waters,97,Comedy,112042871
17000000,3696232,Stephen Moyer,Michael Brandt,98,Drama,-13303768
17000000,4836637,James Woods,Michael Ritchie,98,Action,-12163363
17000000,65535067,Rob Schneider,Mike Mitchell,88,Comedy,48535067
17000000,10000000,Charlton Heston,Nicholas Ray,154,Action,-7000000
17000000,7314027,Hugh Grant,Paul Weitz,107,Comedy,-9685973
17000000,4603929,Ed O'Neill,Peter Faiman,107,Comedy,-12396071
17000000,247275374,Jim Carrey,Peter Farrelly,107,Comedy,230275374
17000000,374743,Dwayne Johnson,Richard Kelly,144,Action,-16625257
17000000,10278549,Tom Berenger,Ridley Scott,106,Crime,-6721451
17000000,16980098,Josh Duhamel,Robert Luketic,95,Comedy,-19902
17000000,12355798,Nicolas Cage,Roger Donaldson,105,Action,-4644202
17000000,2626800,Elisha Cuthbert,Roland Joff√©,96,Crime,-14373200
17000000,14899417,John Krasinski,Sam Mendes,98,Drama,-2100583
17000000,19300000,Christopher Reeve,Sidney J. Furie,90,Action,2300000
17000000,46357676,Matthew Modine,Stanley Kubrick,116,Drama,29357676
17000000,7603766,Jessica Lange,Stephen Gyllenhaal,106,Drama,-9396234
17000000,55041738,Jamie Lee Curtis,Steve Miner,86,Horror,38041738
17000000,33000000,Jeff Bridges,Steven Lisberger,96,Science Fiction,16000000
17000000,124000000,Sylvester Stallone,Sylvester Stallone,99,Drama,107000000
17000000,9627492,Ashley Greene,Todd Lincoln,82,Horror,-7372508
17000000,63102666,Ray Wise,Victor Salva,104,Horror,46102666
17000000,73244881,Ellen Page,Woody Allen,111,Romance,56244881
17080000,21011500,Kevin Bacon,Paul Michael Glaser,107,Comedy,3931500
17500000,25024919,Don Ameche,Daniel Petrie,116,Comedy,7524919
17500000,19179969,Erik Stolhanske,Jay Chandrasekhar,110,Comedy,1679969
17500000,7018189,Forest Whitaker,Kasi Lemmons,93,Drama,-10481811
17500000,38000000,Don Cheadle,Terry George,121,Drama,20500000
17500000,23438120,Malcolm McDowell,Tinto Brass,156,Drama,5938120
17700000,30987695,David Spade,Dennie Gordon,91,Mystery,13287695
17900000,6948633,Arnold Schwarzenegger,Richard Fleischer,89,Adventure,-10951367
18000000,103215094,Michael Keaton,Alejandro Gonz√°lez I√±√°rritu,119,Drama,85215094
18000000,8038061,Kevin Kline,Ang Lee,112,Drama,-9961939
18000000,46908987,Richard Pryor,Arthur Hiller,103,Crime,28908987
18000000,41009669,Jesse Metcalfe,Betty Thomas,87,Comedy,23009669
18000000,62646763,Jessica Alba,Bille Woodruff,94,Music,44646763
18000000,39321715,Kim Basinger,Blake Edwards,95,Comedy,21321715
18000000,36133014,Aaron Eckhart,Brandon Camp,109,Drama,18133014
18000000,266586800,Bruce Willis,Brian A Miller,93,Thriller,248586800
18000000,12000000,John Travolta,Brian De Palma,108,Drama,-6000000
18000000,476684675,Macaulay Culkin,Chris Columbus,103,Comedy,458684675
18000000,358991681,Macaulay Culkin,Chris Columbus,120,Comedy,340991681
18000000,70687344,Clint Eastwood,Clint Eastwood,136,Science Fiction,52687344
18000000,10501938,Ethan Hawke,Courtney Solomon,90,Action,-7498062
18000000,676698,Val Kilmer,D.J. Caruso,103,Drama,-17323302
18000000,35692920,James Franco,Danny Boyle,94,Adventure,17692920
18000000,1196307,Liam Neeson,David Von Ancken,115,Western,-16803693
18000000,11657385,Glen Campbell,Don Bluth,77,Comedy,-6342615
18000000,26828365,Matthew Broderick,Edward Zwick,122,War,8828365
18000000,41382841,Kathleen Turner,Francis Ford Coppola,103,Comedy,23382841
18000000,9495408,Carlo Cecchi,Fran√ßois Girard,131,Drama,-8504592
18000000,123306987,Adam Sandler,Frank Coraci,95,Romance,105306987
18000000,57096190,Thomas Jane,Frank Darabont,126,Science Fiction,39096190
18000000,382174,Billy Bob Thornton,Gregor Jordan,98,Action,-17617826
18000000,25739015,Mark Strong,Guy Ritchie,114,Action,7739015
18000000,72179579,Burt Reynolds,Hal Needham,95,Comedy,54179579
18000000,9697739,Kate Capshaw,Harry Winer,107,Family,-8302261
18000000,75634409,Danny Elfman,Henry Selick,76,Fantasy,57634409
18000000,538400000,Mark Hamill,Irvin Kershner,124,Adventure,520400000
18000000,16702864,Kristen Stewart,James Sbardellati,92,Family,-1297136
18000000,20275812,Josh Brolin,Jason Reitman,111,Drama,2275812
18000000,36602000,Tom Hanks,Joe Dante,101,Comedy,18602000
18000000,98235548,Arnold Schwarzenegger,John McTiernan,107,Science Fiction,80235548
18000000,74189677,Jean-Claude Van Damme,John Woo,97,Action,56189677
18000000,41325328,Meryl Streep,Jonathan Demme,100,Comedy,23325328
18000000,18532286,Matthew Broderick,Jonathan Kaplan,108,Action,532286
18000000,22309223,Jeremy Irvine,Jonathan Teplitzky,116,Drama,4309223
18000000,65070412,Ice Cube,Kevin Rodney Sullivan,106,Comedy,47070412
18000000,261572744,Sacha Baron Cohen,Larry Charles,82,Comedy,243572744
18000000,87000000,William Shatner,Leonard Nimoy,105,Science Fiction,69000000
18000000,3900000,John Lithgow,Marshall Brickman,118,Science Fiction,-14100000
18000000,23000000,Robert De Niro,Martin Scorsese,129,Drama,5000000
18000000,6000000,Peter MacNicol,Matthew Robbins,108,Fantasy,-12000000
18000000,251212670,Rowan Atkinson,Mel Smith,85,Comedy,233212670
18000000,51973029,F. Murray Abraham,Milo≈° Forman,160,Drama,33973029
18000000,17200925,Amanda Schull,Nicholas Hytner,115,Drama,-799075
18000000,268157400,Seth Rogen,Nicholas Stoller,96,Comedy,250157400
18000000,7972967,Dane DeHaan,Nimr√≥d Antal,93,Music,-10027033
18000000,871279,Edgar Ram√≠rez,Olivier Assayas,338,Crime,-17128721
18000000,122195920,Christopher Lambert,Paul W.S. Anderson,101,Action,104195920
18000000,151668774,Tom Hanks,Penny Marshall,104,Fantasy,133668774
18000000,31042035,Arnold Schwarzenegger,Richard Fleischer,103,Adventure,13042035
18000000,9000000,Rex Harrison,Richard Fleischer,152,Adventure,-9000000
18000000,141774679,Reese Witherspoon,Robert Luketic,96,Comedy,123774679
18000000,46201432,Tom Welling,Rupert Wainwright,100,Horror,28201432
18000000,47088990,AnnaSophia Robb,Sean McNamara,106,Action,29088990
18000000,101564935,Ashton Kutcher,Shawn Levy,95,Comedy,83564935
18000000,25005257,Philip Seymour Hoffman,Sidney Lumet,117,Crime,7005257
18000000,389925971,Harrison Ford,Steven Spielberg,115,Adventure,371925971
18000000,5887457,Johnny Depp,Tim Burton,127,Comedy,-12112543
18000000,19265302,Dudley Moore,Willard Huyck,94,Action,1265302
18000000,97505481,Cate Blanchett,Woody Allen,98,Comedy,79505481
18500000,131060248,Sigourney Weaver,James Cameron,137,Horror,112560248
18500000,31912793,Ricky Gervais,Ricky Gervais,100,Comedy,13412793
18500000,10680275,Johnny Depp,Terry Gilliam,118,Adventure,-7819725
18598420,78247647,Jim Belushi,Rod Daniel,101,Action,59649227
19000000,29922472,Amy Adams,Anand Tucker,100,Romance,10922472
19000000,108047131,Ryan Reynolds,Andrew Douglas,90,Horror,89047131
19000000,34619699,Casey Affleck,Ben Affleck,113,Crime,15619699
19000000,40996665,Craig T. Nelson,Brian Gibson,91,Thriller,21996665
19000000,23550000,Juliette Binoche,C√©dric Klapisch,130,Drama,4550000
19000000,8247943,Kevin Dillon,Chuck Russell,95,Horror,-10752057
19000000,68673228,Ken Watanabe,Clint Eastwood,141,Action,49673228
19000000,44332015,Jennifer Aniston,Glenn Gordon Caron,105,Comedy,25332015
19000000,110879513,Al Pacino,Harold Becker,113,Drama,91879513
19000000,5656087,Jason Robards,Jack Clayton,95,Fantasy,-13343913
19000000,10000000,Jack Nicholson,Jack Nicholson,138,Crime,-9000000
19000000,12918858,John Travolta,James Bridges,115,Drama,-6081142
19000000,272742922,Jodie Foster,Jonathan Demme,118,Crime,253742922
19000000,174999005,Julia Roberts,Joseph Ruben,99,Crime,155999005
19000000,49830607,Jason Bateman,Josh Gordon,101,Comedy,30830607
19000000,278019771,Carmen Electra,Keenen Ivory Wayans,88,Comedy,259019771
19000000,91379051,Derek Mears,Marcus Nispel,97,Horror,72379051
19000000,70067909,Hilary Duff,Mark Rosman,95,Comedy,51067909
19000000,141407024,Will Smith,Michael Bay,118,Adventure,122407024
19000000,6928068,Topher Grace,Michael Dowse,97,Comedy,-12071932
19000000,35300645,Kate Beckinsale,Nimr√≥d Antal,80,Horror,16300645
19000000,6682098,Sean Penn,Oliver Stone,125,Thriller,-12317902
19000000,61389680,Sean Astin,Richard Donner,114,Adventure,42389680
19000000,25836616,George Clooney,Robert Rodriguez,108,Horror,6836616
19000000,381109762,Michael J. Fox,Robert Zemeckis,116,Adventure,362109762
19000000,144216468,Laura Linney,Scott Derrickson,122,Crime,125216468
19000000,18755936,Josh Zuckerman,Sean Anders,109,Comedy,-244064
19000000,32801173,Nicolas Cage,Spike Jonze,114,Comedy,13801173
19000000,44017374,Jack Nicholson,Stanley Kubrick,144,Horror,25017374
19000000,69631118,Seth Green,Steven Brill,95,Action,50631118
19000000,35387212,Neil Patrick Harris,Todd Strauss-Schulson,108,Comedy,16387212
19000000,39267515,Mimi Rogers,Troy Miller,85,Comedy,20267515
19000000,40846082,Geoffrey Rush,William Malone,93,Horror,21846082
19000000,18254702,Woody Allen,Woody Allen,104,Comedy,-745298
19100000,5728213,Dominic Cooper,Lee Tamahori,109,Drama,-13371787
19250000,8112712,Val Kilmer,David Mamet,102,Mystery,-11137288
19500000,32189727,Chiwetel Ejiofor,Billy Ray,111,Crime,12689727
19800000,87754044,Helen Mirren,Robert Altman,137,Drama,67954044
19800000,41296320,Jason Bateman,Shawn Levy,103,Drama,21496320
19885552,19724334,D. B. Sweeney,Robert Lieberman,109,Drama,-161218
20000000,48548426,Alyson Hannigan,Aaron Seltzer,83,Comedy,28548426
20000000,132675402,Steve Martin,Adam Shankman,105,Comedy,112675402
20000000,60427839,Sean Penn,Alejandro Gonz√°lez I√±√°rritu,124,Drama,40427839
20000000,6420319,Jakob Salvati,Alejandro Monteverde,106,Comedy,-13579681
20000000,177243185,George Clooney,Alexander Payne,115,Comedy,157243185
20000000,50012507,Keanu Reeves,Alfonso Ar√°u,103,Drama,30012507
20000000,33889159,Amanda Bynes,Andy Fickman,105,Comedy,13889159
20000000,32005248,Kristen Bell,Andy Fickman,105,Comedy,12005248
20000000,39300000,Hayden Panettiere,Anthony Bell,88,Family,19300000
20000000,27187375,Jake T. Austin,Anthony Silverston,85,Animation,7187375
20000000,65464324,George Clooney,Anton Corbijn,104,Crime,45464324
20000000,1969193,Michael Shannon,Ariel Vromen,105,Thriller,-18030807
20000000,66787908,David Oyelowo,Ava DuVernay,127,History,46787908
20000000,41237648,Robin Williams,Barry Levinson,115,Comedy,21237648
20000000,100525432,Melissa McCarthy,Ben Falcone,97,Comedy,80525432
20000000,16549477,Josh Holloway,Benson Lee,110,Music,-3450523
20000000,37095657,Brittany Murphy,Boaz Yakin,92,Comedy,17095657
20000000,43967255,Thomas Haden Church,Boaz Yakin,111,Adventure,23967255
20000000,54956140,Timothy Olyphant,Breck Eisner,101,Mystery,34956140
20000000,41637263,Kevin Costner,Bruce A. Evans,120,Drama,21637263
20000000,11390479,Andy Garc√≠a,Bruce Robinson,124,Crime,-8609521
20000000,136267476,Zac Efron,Burr Steers,102,Comedy,116267476
20000000,78739897,Keanu Reeves,Chad Stahelski,101,Action,58739897
20000000,57588485,Nick Cannon,Charles Stone III,118,Drama,37588485
20000000,17432163,Jason Lee,Chris Koch,101,Comedy,-2567837
20000000,5781885,Peter Weller,Christian Duguay,108,Horror,-14218115
20000000,21170563,T.I.,Christian Robinson,105,Drama,1170563
20000000,117760134,Shia LaBeouf,D.J. Caruso,105,Thriller,97760134
20000000,24261569,James McAvoy,Danny Boyle,101,Thriller,4261569
20000000,65569869,Keanu Reeves,David Ayer,109,Action,45569869
20000000,4636169,Bruce Willis,David Barrett,97,Action,-15363831
20000000,610792,Bella Heathcote,David Chase,112,Drama,-19389208
20000000,70992898,Johnny Messner,Dwight H. Little,97,Adventure,50992898
20000000,20211394,Viggo Mortensen,Ed Harris,115,Drama,211394
20000000,35841901,Maximilian Schell,Gary Nelson,98,Adventure,15841901
20000000,12000000,Max von Sydow,George Stevens,199,Drama,-8000000
20000000,208588,Charlize Theron,Gilles Paquet-Brenner,113,Drama,-19791412
20000000,3561,Catherine Zeta-Jones,Gillian Armstrong,97,Drama,-19996439
20000000,27728118,"Chris Warren, Jr.",Gina Prince-Bythewood,124,Action,7728118
20000000,12482775,Nicolas Cage,Gore Verbinski,101,Comedy,-7517225
20000000,1531251,Christopher Lambert,Graham Baker,95,Action,-18468749
20000000,169860655,Jonah Hill,Greg Mottola,113,Comedy,149860655
20000000,60000000,Jennifer Lopez,Gregory Nava,127,Documentary,40000000
20000000,21284514,Nicole Kidman,Gus Van Sant,106,Fantasy,1284514
20000000,54586584,Sean Penn,Gus Van Sant,128,History,34586584
20000000,36620508,Dane Cook,Howard Deutch,101,Comedy,16620508
20000000,7563728,Jonny Lee Miller,Iain Softley,107,Action,-12436272
20000000,12007070,Oscar Isaac,J.C. Chandor,125,Action,-7992930
20000000,216197492,Jason Segel,Jake Kasdan,92,Comedy,196197492
20000000,51249404,William Hurt,James L. Brooks,133,Comedy,31249404
20000000,15379253,Jim Belushi,James Orr,110,Fantasy,-4620747
20000000,16974459,Kevin Bacon,James Wan,105,Action,-3025541
20000000,22217407,Ryan Kwanten,James Wan,89,Horror,2217407
20000000,80547866,Chris Riggi,Jason Friedberg,82,Horror,60547866
20000000,86865564,Kal Penn,Jason Friedberg,86,Action,66865564
20000000,41596251,Vera Farmiga,Jaume Collet-Serra,123,Horror,21596251
20000000,77200000,Sean Connery,Jean-Jacques Annaud,130,Drama,57200000
20000000,187884007,Roy Scheider,Jeannot Szwarc,116,Horror,167884007
20000000,41627431,Sean Faris,Jeff Wadlow,115,Drama,21627431
20000000,49779728,Alice Eve,Jim Field Smith,104,Comedy,29779728
20000000,22165608,John Cena,John Bonito,92,Action,2165608
20000000,75597042,Dennis Quaid,John Lee Hancock,127,Drama,55597042
20000000,47241945,Alexandra Daddario,John Luessenhop,92,Horror,27241945
20000000,7535331,Gwyneth Paltrow,John Madden,100,Drama,-12464669
20000000,45636368,Helen Mirren,John Madden,113,Drama,25636368
20000000,67200000,Matt Dillon,John McNaughton,108,Crime,47200000
20000000,68851475,Arnold Schwarzenegger,John Milius,129,Adventure,48851475
20000000,50907234,Amy Adams,John Patrick Shanley,104,Drama,30907234
20000000,36606743,Bradley Cooper,John Wells,100,Drama,16606743
20000000,13801755,Bill Murray,Jon Amiel,97,Comedy,-6198245
20000000,1017401,Dennis Quaid,Jonas kerlund,90,Crime,-18982599
20000000,13204291,Matthew Goode,Julian Jarrold,133,Drama,-6795709
20000000,346594,Helen Mirren,Julie Taymor,110,Fantasy,-19653406
20000000,136150434,Tobin Bell,Kevin Greutert,90,Horror,116150434
20000000,4634062,Brandon Routh,Kevin Munroe,107,Action,-15365938
20000000,305070,Jason Scott Lee,Kevin Reynolds,107,Adventure,-19694930
20000000,5716080,Samuel L. Jackson,Kevin Reynolds,119,Drama,-14283920
20000000,37672350,Angela Bassett,Kevin Rodney Sullivan,124,Comedy,17672350
20000000,5359645,Christian Bale,Kurt Wimmer,107,Action,-14640355
20000000,10337477,Cedric the Entertainer,Les Mayfield,84,Action,-9662523
20000000,16863583,Henry Cavill,Mabrouk El Mechri,93,Action,-3136417
20000000,78378744,Simon Rex,Malcolm D. Lee,86,Comedy,58378744
20000000,73276047,Khalid Abdalla,Marc Forster,128,Drama,53276047
20000000,33526835,Ice Cube,Marcus Raboy,85,Comedy,13526835
20000000,30426096,Chris Evans,Mark Mylod,106,Comedy,10426096
20000000,34560577,Jason Statham,Mark Neveldine,96,Action,14560577
20000000,18253415,Jim Carrey,Mark Steven Johnson,114,Comedy,-1746585
20000000,24145613,Kodi Smit-McPhee,Matt Reeves,116,Drama,4145613
20000000,35739755,Cary Elwes,Mel Brooks,104,Comedy,15739755
20000000,84146832,Sandra Bullock,Mennan Yapo,110,Fantasy,64146832
20000000,52302796,Adelaide Clemens,Michael J. Bassett,94,Thriller,32302796
20000000,11341016,Nia Vardalos,Michael Lembeck,98,Comedy,-8658984
20000000,17436509,Michael Moore,Michael Moore,120,Documentary,-2563491
20000000,6819587,Demi Moore,Michael Radford,108,Crime,-13180413
20000000,51416464,Ethan Hawke,Michael Spierig,98,Fantasy,31416464
20000000,72258126,Jim Carrey,Michel Gondry,108,Science Fiction,52258126
20000000,22222308,Adam Sandler,Mike Binder,124,Drama,2222308
20000000,51684798,Matthew Broderick,Mike Nichols,106,Comedy,31684798
20000000,8586376,Cuba Gooding Jr.,Mort Nathan,94,Comedy,-11413624
20000000,27640028,Samuel L. Jackson,Neil LaBute,110,Drama,7640028
20000000,22942221,Columbus Short,Nimr√≥d Antal,88,Action,2942221
20000000,16605763,Cole Hauser,Paul Abascal,84,Action,-3394237
20000000,11110975,Joaquin Phoenix,Paul Thomas Anderson,148,Comedy,-8889025
20000000,121697323,Mike Myers,Penelope Spheeris,94,Comedy,101697323
20000000,149281606,Drew Barrymore,Raja Gosnell,91,Adventure,129281606
20000000,167722310,Vince Vaughn,Rawson Marshall Thurber,92,Comedy,147722310
20000000,17280326,John Cena,Renny Harlin,108,Action,-2719674
20000000,17479,Rupert Friend,Renny Harlin,113,War,-19982521
20000000,37597471,Steven Strait,Renny Harlin,97,Action,17597471
20000000,5530764,Rachel Weisz,Rian Johnson,114,Adventure,-14469236
20000000,13854000,Dan Aykroyd,Richard Benjamin,108,Comedy,-6146000
20000000,18432000,Matthew Broderick,Richard Donner,121,Adventure,-1568000
20000000,61276872,James Caan,Rob Reiner,107,Horror,41276872
20000000,22471595,Olivia Newton-John,Robert Greenwald,96,Fantasy,2471595
20000000,31327899,Danny Trejo,Robert Rodriguez,105,Action,11327899
20000000,109862682,Harriet Owen,Robin Budd,72,Adventure,89862682
20000000,64822796,Jason Statham,Roger Donaldson,112,Thriller,44822796
20000000,171504781,Tom Cruise,Roger Donaldson,104,Drama,151504781
20000000,17637950,Harrison Ford,Roman Polanski,120,Thriller,-2362050
20000000,34077920,Alex Pettyfer,Shana Feste,103,Drama,14077920
20000000,47738099,Scarlett Johansson,Shari Springer Berman,106,Comedy,27738099
20000000,153698625,Jason James Richter,Simon Wincer,112,Family,133698625
20000000,67192859,Emily Deschanel,Stephen Kay,89,Thriller,47192859
20000000,32204030,Guy Pearce,Stephen St. Leger,95,Action,12204030
20000000,187000000,Chiwetel Ejiofor,Steve McQueen,134,Drama,167000000
20000000,73830340,Beyonc√© Knowles,Steve Shill,108,Drama,53830340
20000000,135680000,John Goodman,Steve Trenbirth,72,Family,115680000
20000000,8352885,Jason Statham,Steven Knight,100,Action,-11647115
20000000,303788635,Richard Dreyfuss,Steven Spielberg,135,Science Fiction,283788635
20000000,39143839,Sarah Michelle Gellar,Takashi Shimizu,102,Horror,19143839
20000000,17425000,Selena Gomez,Thomas Bezucha,109,Adventure,-2575000
20000000,11585483,Mike Myers,Thomas Schlamme,93,Comedy,-8414517
20000000,53000000,Johnny Depp,Tim Burton,105,Fantasy,33000000
20000000,5210988,Vanessa Hudgens,Todd Graff,111,Comedy,-14789012
20000000,4001121,Cate Blanchett,Todd Haynes,135,Drama,-15998879
20000000,17807569,Billy Bob Thornton,Todd Phillips,100,Comedy,-2192431
20000000,66673516,Dan Aykroyd,Tom Mankiewicz,106,Action,46673516
20000000,88346473,Mark Ruffalo,Tom McCarthy,128,Drama,68346473
20000000,23875127,Edward Norton,Tony Kaye,119,Drama,3875127
20000000,299965036,Eddie Murphy,Tony Scott,100,Action,279965036
20000000,60072596,Tyler Perry,Tyler Perry,121,Comedy,40072596
20000000,10442808,Christian Slater,Uwe Boll,96,Action,-9557192
20000000,45833132,Richard Pryor,Walter Hill,97,Comedy,25833132
20000000,12398628,Wesley Snipes,Walter Hill,96,Action,-7601372
20000000,18599102,Nicholas D'Agosto,Will Gluck,90,Comedy,-1400898
20000000,3970078,Gillian Anderson,Willard Carroll,121,Comedy,-16029922
20500000,6063556,Robert Pattinson,David Cronenberg,109,Drama,-14436444
20500000,87987055,Dennis Quaid,Joe Alves,99,Horror,67487055
20500000,10089373,Ray Stevenson,Lexi Alexander,102,Action,-10410627
21000000,10011050,Jake Gyllenhaal,Brad Silberling,117,Romance,-10988950
21000000,480314,Jaime Pressly,Corey Yuen Kwai,87,Adventure,-20519686
21000000,72417394,Zachary Gordon,David Bowers,99,Family,51417394
21000000,205738714,Bradley Cooper,David O. Russell,122,Drama,184738714
21000000,23450000,Whoopi Goldberg,Herbert Ross,115,Comedy,2450000
21000000,54926886,Joaquin Phoenix,James Gray,117,Drama,33926886
21000000,970816,Jodie Foster,Jodie Foster,91,Drama,-20029184
21000000,28008462,Pierce Brosnan,John Boorman,109,Drama,7008462
21000000,17600000,Kevin Costner,Joshua Michael Stern,120,Drama,-3400000
21000000,17762705,Emily Bergl,Katt Shea,104,Horror,-3237295
21000000,43928932,Jason Statham,Louis Leterrier,92,Action,22928932
21000000,49050886,Zoe Saldana,Neil LaBute,92,Comedy,28050886
21000000,227799884,Tom Hanks,Nora Ephron,105,Comedy,206799884
21000000,41170784,Hilary Swank,Richard LaGravenese,123,Crime,20170784
21000000,177200000,Dustin Hoffman,Sydney Pollack,116,Comedy,156200000
21000000,71441250,Gene Hackman,Wes Anderson,110,Comedy,50441250
21150000,39438674,Paul Hogan,Simon Wincer,92,Adventure,18288674
22000000,147880543,Dwayne Johnson,Andy Fickman,110,Comedy,125880543
22000000,26570463,Tom Everett Scott,Anthony Waller,105,Horror,4570463
22000000,851517,Julianne Moore,Bj√∂rn Stein,112,Horror,-21148483
22000000,67800064,Roma Downey,Christopher Spencer,138,Drama,45800064
22000000,67642693,Clint Eastwood,Clint Eastwood,117,Action,45642693
22000000,77112176,Devon Bostick,David Bowers,94,Comedy,55112176
22000000,19351569,Jason Biggs,Dennis Dugan,90,Comedy,-2648431
22000000,24188922,Naomi Watts,Doug Liman,108,Drama,2188922
22000000,10696210,Robert John Burke,Fred Dekker,104,Action,-11303790
22000000,43058898,Jason Statham,Gary Fleder,100,Action,21058898
22000000,1106279658,Sandra Bullock,Irwin Winkler,114,Crime,1084279658
22000000,23530831,Don Cheadle,Jeffrey Nachmanoff,114,Drama,1530831
22000000,505000000,Patrick Swayze,Jerry Zucker,127,Fantasy,483000000
22000000,40270895,Sean Penn,Jessie Nelson,132,Drama,18270895
22000000,42313354,Roy Scheider,John Badham,109,Science Fiction,20313354
22000000,28744356,Jeff Bridges,John Carpenter,115,Action,6744356
22000000,9479718,Frances Conroy,John Curran,105,Drama,-12520282
22000000,413454,Paul Walker,John Herzfeld,97,Drama,-21586546
22000000,189833357,Tim Allen,John Pasquin,97,Fantasy,167833357
22000000,424208848,Kevin Costner,Kevin Costner,181,Adventure,402208848
22000000,68296293,Kevin Costner,Kevin Costner,139,Western,46296293
22000000,33788161,Kevin Smith,Kevin Smith,104,Comedy,11788161
22000000,88880821,Helen Mirren,Lasse Hallstr√∂m,122,Drama,66880821
22000000,95708457,Kate Beckinsale,Len Wiseman,121,Fantasy,73708457
22000000,13405595,Jack Black,Liam Lynch,93,Comedy,-8594405
22000000,84772742,Rob Schneider,Luke Greenfield,84,Action,62772742
22000000,57479076,Clive Owen,Mikael H√•fstr√∂m,108,Drama,35479076
22000000,22400154,Rob Schneider,Mike Bigelow,83,Comedy,400154
22000000,39071603,Meryl Streep,Mike Nichols,101,Comedy,17071603
22000000,77737889,Ben Kingsley,Richard Attenborough,191,Drama,55737889
22000000,50750000,Dirk Bogarde,Richard Attenborough,175,Drama,28750000
22000000,17287898,Robert De Niro,Robert De Niro,121,Drama,-4712102
22000000,15400000,Christian Bale,Scott Cooper,116,Thriller,-6600000
22000000,35424826,Matt Damon,Steven Soderbergh,108,Comedy,13424826
22000000,321265768,Liam Neeson,Steven Spielberg,195,Drama,299265768
22000000,64892670,John Travolta,Sylvester Stallone,93,Drama,42892670
22000000,13555988,Richard E. Grant,Uli Edel,95,Horror,-8444012
22000000,12000000,Roy Scheider,William Friedkin,121,Action,-10000000
22000000,11511031,Tom Berenger,Wolfgang Petersen,98,Mystery,-10488969
22500000,18671317,Michael J. Fox,Brian De Palma,113,Drama,-3828683
22500000,15520023,Russell Crowe,Russell Crowe,112,War,-6979977
22700000,38119483,Mel Brooks,Mel Brooks,96,Comedy,15419483
23000000,43984230,John Lone,Bernardo Bertolucci,163,Drama,20984230
23000000,369884651,Cameron Diaz,Bobby Farrelly,119,Romance,346884651
23000000,351583407,Jim Carrey,Chuck Russell,101,Romance,328583407
23000000,53187659,Vin Diesel,David Twohy,109,Thriller,30187659
23000000,86930411,Leslie Nielsen,David Zucker,85,Action,63930411
23000000,71368,Dom DeLuise,Don Bluth,76,Fantasy,-22928632
23000000,185991646,Adam Sandler,Frank Coraci,90,Comedy,162991646
23000000,53302314,Devon Sawa,James Wong,98,Horror,30302314
23000000,79799880,Kevin Hart,Jeremy Garelick,101,Comedy,56799880
23000000,36642838,Steve Zahn,John Dahl,97,Mystery,13642838
23000000,150816700,Briana Evigan,Jon M. Chu,98,Music,127816700
23000000,57138719,Kurt Russell,Jonathan Kaplan,117,Crime,34138719
23000000,51881013,Lorraine Gary,Joseph Sargent,89,Adventure,28881013
23000000,20246790,Christian Slater,Michael Karbelnikoff,104,Drama,-2753210
23000000,16123851,Reese Witherspoon,Mira Nair,141,Drama,-6876149
23000000,10827816,Ralph Fiennes,Neil Jordan,102,Drama,-12172184
23000000,29541790,Tommy Lee Jones,Paul Haggis,124,History,6541790
23000000,7434726,Mickey Rourke,Simon Wincer,98,Action,-15565274
23000000,47351251,Joaquin Phoenix,Spike Jonze,126,Romance,24351251
23000000,9366227,Michelle Pfeiffer,Stephen Frears,86,Drama,-13633773
23000000,38505009,Justin Long,Steve Pink,93,Comedy,15505009
23000000,33372606,Gina Carano,Steven Soderbergh,93,Thriller,10372606
23000000,15600000,Michael Douglas,Steven Soderbergh,118,Drama,-7400000
23000000,76488889,Billy Bob Thornton,Terry Zwigoff,91,Drama,53488889
23000000,18653615,Susan Sarandon,Wayne Wang,114,Drama,-4346385
23600000,102391382,Jesse Eisenberg,Ruben Fleischer,88,Comedy,78791382
24000000,23321954,Viggo Mortensen,Agust√≠n D√≠az Yanes,145,Action,-678046
24000000,83188165,Elisabeth Shue,Alexandre Aja,88,Comedy,59188165
24000000,9576495,Michelle Pfeiffer,Amy Heckerling,97,Comedy,-14423505
24000000,12096300,Steve Carell,Bennett Miller,134,Drama,-11903700
24000000,36609995,David Duchovny,Bonnie Hunt,115,Romance,12609995
24000000,14782676,Jason London,Brendan Malloy,89,Comedy,-9217324
24000000,12372410,David Arquette,Brian Robbins,107,Action,-11627590
24000000,182016617,Meryl Streep,Clint Eastwood,135,Drama,158016617
24000000,63543328,Kenny Wormald,Craig Brewer,113,Drama,39543328
24000000,30551495,Sarah Jessica Parker,Douglas McGrath,89,Comedy,6551495
24000000,23081726,Dwayne Johnson,"George Tillman, Jr.",98,Crime,-918274
24000000,68729358,George Clooney,Grant Heslov,93,Comedy,44729358
24000000,43455230,John Candy,Howard Deutch,91,Comedy,19455230
24000000,52614445,Jeff Bridges,John Guillermin,134,Action,28614445
24000000,83531958,Patrick Swayze,Kathryn Bigelow,120,Action,59531958
24000000,42105111,Seth Rogen,Kevin Smith,102,Comedy,18105111
24000000,88545092,Tobey Maguire,Lasse Hallstr√∂m,126,Drama,64545092
24000000,133000000,William Shatner,Leonard Nimoy,119,Science Fiction,109000000
24000000,23510601,Laurence Fishburne,Reggie Rock Bythewood,110,Action,-489399
24000000,13700000,Tim Meadows,Reginald Hudlin,84,Comedy,-10300000
24000000,8434146,Antonio Banderas,Ron Shelton,124,Comedy,-15565854
24000000,21049053,Diana Ross,Sidney Lumet,134,Adventure,-2950947
24000000,155721132,Sylvester Stallone,Sylvester Stallone,102,Drama,131721132
24000000,41895491,Jeff Bridges,Terry Gilliam,137,Drama,17895491
24000000,22518097,Kurt Russell,Thom Eberhardt,100,Action,-1481903
24000000,16290976,Steve Whitmire,Tim Hill,87,Fantasy,-7709024
24000000,70181428,Kevin Hart,Tim Story,106,Comedy,46181428
24000000,87055349,Luke Wilson,Todd Phillips,91,Comedy,63055349
24000000,172363301,David Arquette,Wes Craven,120,Horror,148363301
24000000,99965753,Timothy Olyphant,Xavier Gens,89,Action,75965753
24500000,17218023,Robert De Niro,Roland Joff√©,126,Adventure,-7281977
25000000,25965144,Tim Robbins,Adrian Lyne,113,Drama,965144
25000000,135330182,Brad Pitt,Alejandro Gonz√°lez I√±√°rritu,143,Drama,110330182
25000000,55494066,Gwyneth Paltrow,Alfonso Cuar√≥n,111,Comedy,30494066
25000000,91036760,Jet Li,Andrzej Bartkowiak,115,Action,66036760
25000000,56489558,Jet Li,Andrzej Bartkowiak,101,Action,31489558
25000000,119772232,Billy Crystal,Andy Fickman,104,Comedy,94772232
25000000,30000000,John Cusack,Anthony Leondis,87,Animation,5000000
25000000,63100000,Mark Wahlberg,Baltasar Korm√°kur,109,Thriller,38100000
25000000,6673422,Bruce Willis,Barry Levinson,104,Comedy,-18326578
25000000,354825435,Dustin Hoffman,Barry Levinson,133,Drama,329825435
25000000,2075084,Debra Winger,Bernardo Bertolucci,138,Adventure,-22924916
25000000,15431177,Shia LaBeouf,Bill Paxton,120,Drama,-9568823
25000000,36351350,Queen Latifah,Bille Woodruff,105,Comedy,11351350
25000000,2438031,Roberto Benigni,Blake Edwards,93,Comedy,-22561969
25000000,100000000,Victoria Beckham,Bob Spiers,93,Adventure,75000000
25000000,65884703,Al Pacino,Brian De Palma,170,Action,40884703
25000000,76270454,Kevin Costner,Brian De Palma,119,Crime,51270454
25000000,42972994,Tom Hardy,Brian Helgeland,131,Crime,17972994
25000000,20719451,Chi Cao,Bruce Beresford,117,Drama,-4280549
25000000,5549200,Morgan Freeman,Bruce Beresford,96,Drama,-19450800
25000000,72629670,Ed Skrein,Camille Delamarre,96,Thriller,47629670
25000000,13411957,Emile Hirsch,Catherine Hardwicke,107,Drama,-11588043
25000000,441286195,Robin Williams,Chris Columbus,125,Comedy,416286195
25000000,64437847,Jet Li,Chris Nahon,98,Action,39437847
25000000,156822020,Sean Penn,Clint Eastwood,138,Thriller,131822020
25000000,38307627,Jon Hamm,Craig Gillespie,124,Drama,13307627
25000000,34942188,Sam Rockwell,David Gordon Green,81,Comedy,9942188
25000000,11838218,Keenen Ivory Wayans,David Hogan,99,Action,-13161782
25000000,9190869,Mark Wahlberg,David O. Russell,116,Drama,-15809131
25000000,56422687,Chris Evans,David R. Ellis,94,Action,31422687
25000000,14048372,Charlie Sheen,David Twohy,115,Action,-10951628
25000000,15843608,Christopher Lambert,Douglas Aarniokoski,87,Action,-9156392
25000000,22611954,Damon Wayans,Ernest R. Dickerson,84,Action,-2388046
25000000,19844979,Mark Ruffalo,Fernando Meirelles,121,Drama,-5155021
25000000,82466670,Ralph Fiennes,Fernando Meirelles,129,Drama,57466670
25000000,28341469,Tim Robbins,Frank Darabont,142,Drama,3341469
25000000,38748395,Rick Moranis,Frank Oz,94,Horror,13748395
25000000,70442940,Anna Faris,Fred Wolf,97,Romance,45442940
25000000,377350553,Paige O'Hara,Gary Trousdale,84,Romance,352350553
25000000,23057115,Tom Hardy,Gavin O'Connor,140,Action,-1942885
25000000,56505065,Kurt Russell,George P. Cosmatos,130,Action,31505065
25000000,27685016,Diego Luna,Guy Ferland,86,Drama,2685016
25000000,147780440,Natalie Portman,Ivan Reitman,108,Comedy,122780440
25000000,15156200,Mark Wahlberg,James Foley,110,Action,-9843800
25000000,117719158,Mary Elizabeth Winstead,James Wong,93,Horror,92719158
25000000,14109284,Matt Lanter,Jason Friedberg,87,Action,-10890716
25000000,163670000,George Clooney,Jason Reitman,109,Drama,138670000
25000000,20796847,Scott Mechlowicz,Jeff Schaffer,93,Comedy,-4203153
25000000,22200000,Johnny Depp,Jeremy Leven,97,Romance,-2800000
25000000,133752825,Charlie Sheen,Jim Abrahams,86,Action,108752825
25000000,12729917,David Bowie,Jim Henson,101,Adventure,-12270083
25000000,77278331,Liam Neeson,Joe Carnahan,117,Action,52278331
25000000,9873044,Ethan Hawke,Joe Dante,109,Adventure,-15126956
25000000,171600000,Tommy Lee Jones,Joel Coen,122,Crime,146600000
25000000,40903593,Michael Douglas,Joel Schumacher,113,Crime,15903593
25000000,80936232,Debi Derryberry,John A. Davis,83,Adventure,55936232
25000000,11000000,Kurt Russell,John Carpenter,99,Adventure,-14000000
25000000,5778353,Tanya Roberts,John Guillermin,117,Adventure,-19221647
25000000,289317794,Joseph Fiennes,John Madden,122,History,264317794
25000000,119188334,Liev Schreiber,John Moore,110,Drama,94188334
25000000,122644820,Robert De Niro,John Polson,101,Horror,97644820
25000000,24362772,Madonna,John Schlesinger,108,Comedy,-637228
25000000,432274,Halle Berry,John Stockwell,113,Thriller,-24567726
25000000,51842679,Kate Bosworth,John Stockwell,104,Adventure,26842679
25000000,74188937,Meryl Streep,John Wells,121,Comedy,49188937
25000000,13000000,Claire Danes,Jonathan Kaplan,100,Drama,-12000000
25000000,52395996,Joseph Gordon-Levitt,Jonathan Levine,100,Comedy,27395996
25000000,6399,Aneurin Barnard,Jonathan Newman,99,Fantasy,-24993601
25000000,2054941,Keanu Reeves,Keanu Reeves,105,Action,-22945059
25000000,39053061,Amber Tamblyn,Ken Kwapis,119,Drama,14053061
25000000,17193231,Laurence Fishburne,Kevin Hooks,98,Action,-7806769
25000000,27122040,Channing Tatum,Kevin Macdonald,114,Adventure,2122040
25000000,11207130,Ryan Phillippe,Kimberly Peirce,113,Drama,-13792870
25000000,122489822,Emma Thompson,Kirk Jones,97,Fantasy,97489822
25000000,66122026,Freddie Highmore,Kirsten Sheridan,114,Drama,41122026
25000000,114977104,Amanda Seyfried,Lasse Hallstr√∂m,115,Drama,89977104
25000000,152500343,Juliette Binoche,Lasse Hallstr√∂m,121,Comedy,127500343
25000000,11772461,Richard Gere,Lasse Hallstr√∂m,116,Comedy,-13227539
25000000,115922175,Forest Whitaker,Lee Daniels,132,Drama,90922175
25000000,42629776,Blake Lively,Lee Toland Krieger,112,Fantasy,17629776
25000000,96773200,Michael Douglas,Lewis Teague,106,Action,71773200
25000000,30411183,Emile Hirsch,Luke Greenfield,108,Comedy,5411183
25000000,41604473,Eddie Griffin,Malcolm D. Lee,86,Action,16604473
25000000,116766556,Johnny Depp,Marc Forster,106,Drama,91766556
25000000,17741298,Hugh Jackman,Marcel Langenegger,107,Drama,-7258702
25000000,59192128,Dane Cook,Mark Helfrich,101,Comedy,34192128
25000000,46836394,Robert De Niro,Martin Scorsese,146,Drama,21836394
25000000,170764026,Lizzy Caplan,Matt Reeves,85,Action,145764026
25000000,16057580,Sylvester Stallone,Menahem Golan,93,Action,-8942420
25000000,86175291,Mark Wahlberg,Michael Bay,130,Thriller,61175291
25000000,79817939,Eddie Murphy,Michael Ritchie,94,Action,54817939
25000000,411006740,Whitney Houston,Mick Jackson,129,Thriller,386006740
25000000,94679598,John Cusack,Mikael H√•fstr√∂m,104,Horror,69679598
25000000,10113733,Gwyneth Paltrow,Neil LaBute,102,Drama,-14886267
25000000,30114487,Greg Kinnear,Nick Hamm,102,Drama,5114487
25000000,11790979,Sean Penn,Paolo Sorrentino,118,Drama,-13209021
25000000,24902723,Antonio Banderas,Patricia Riggen,120,History,-97277
25000000,17000000,Adam Sandler,Paul Thomas Anderson,95,Comedy,-8000000
25000000,76181545,Daniel Day-Lewis,Paul Thomas Anderson,158,Drama,51181545
25000000,68377859,Steve Carell,Peter Hedges,98,Comedy,43377859
25000000,4388563,Michael Douglas,Peter Hyams,105,Drama,-20611437
25000000,40452643,Jet Li,Philip G. Atwell,103,Action,15452643
25000000,66980456,Jeff Bridges,Phillip Noyce,94,Drama,41980456
25000000,226830568,Liam Neeson,Pierre Morel,93,Action,201830568
25000000,25037897,Kurt Russell,Quentin Tarantino,113,Action,37897
25000000,6600000,Lori Petty,Rachel Talalay,98,Action,-18400000
25000000,84565230,Drew Barrymore,Raja Gosnell,107,Romance,59565230
25000000,38348988,Clint Eastwood,Richard Benjamin,93,Action,13348988
25000000,10070000,Shirley MacLaine,Richard Benjamin,105,Comedy,-14930000
25000000,227853986,Mel Gibson,Richard Donner,114,Action,202853986
25000000,2336172,Zac Efron,Richard Linklater,114,Comedy,-22663828
25000000,12000000,Miranda Richardson,Richard Rich,87,Animation,-13000000
25000000,71009334,Michael Fassbender,Ridley Scott,117,Thriller,46009334
25000000,15502112,Tom Cruise,Ridley Scott,114,Action,-9497888
25000000,51702483,Jean-Claude Van Damme,Ringo Lam,100,Action,26702483
25000000,45300000,Lee Marvin,Robert Aldrich,150,Action,20300000
25000000,15478800,Evan Rachel Wood,Robert Redford,122,Crime,-9521200
25000000,777423,Billy Crudup,Robert Towne,117,Drama,-24222577
25000000,10324441,James Marsden,Rod Lurie,110,Thriller,-14675559
25000000,4152230,Devon Sawa,Rodman Flender,92,Thriller,-20847770
25000000,2000000,Anne Hathaway,Rodrigo Garc√≠a,93,Drama,-23000000
25000000,27603069,Kate Winslet,Roman Polanski,80,Comedy,2603069
25000000,50671850,Ed Gale,Ronny Yu,89,Comedy,25671850
25000000,39171130,Mark Wahlberg,Rupert Wyatt,111,Thriller,14171130
25000000,48063435,Alec Baldwin,Russell Mulcahy,108,Adventure,23063435
25000000,99357138,Zac Efron,Scott Hicks,101,Drama,74357138
25000000,281929795,Ren√©e Zellweger,Sharon Maguire,97,Comedy,256929795
25000000,74237563,Cate Blanchett,Shekhar Kapur,114,Drama,49237563
25000000,21567853,Denzel Washington,Spike Lee,136,Drama,-3432147
25000000,13071518,Harvey Keitel,Spike Lee,128,Mystery,-11928482
25000000,108846072,Nicole Kidman,Stephen Daldry,114,Drama,83846072
25000000,10719357,Katie Holmes,Stephen Gaghan,99,Drama,-14280643
25000000,260562,Gene Hackman,Stephen Hopkins,110,Mystery,-24739438
25000000,36400360,Chevy Chase,Stephen Kessler,93,Comedy,11400360
25000000,229736344,Rowan Atkinson,Steve Bendelack,90,Family,204736344
25000000,16158487,Jennifer Garner,Susannah Grant,111,Comedy,-8841513
25000000,23580000,Jeffrey Dean Morgan,Sylvain White,97,Action,-1420000
25000000,124272124,Emma Stone,Tate Taylor,146,Drama,99272124
25000000,21288692,Grant Bardsley,Ted Berman,80,Animation,-3711308
25000000,27645491,Michelle Trachtenberg,Tim Fywell,98,Comedy,2645491
25000000,153997819,Ice Cube,Tim Story,99,Action,128997819
25000000,36609966,Queen Latifah,Tim Story,97,Thriller,11609966
25000000,92991835,George Clooney,Tony Gilroy,119,Drama,67991835
25000000,36993168,Katie Holmes,Troy Nixey,99,Fantasy,11993168
25000000,53213633,Tyler Perry,Tyler Perry,106,Comedy,28213633
25000000,2405420,Kristanna Loken,Uwe Boll,95,Action,-22594580
25000000,11137801,Fairuza Balk,Walter Murch,113,Adventure,-13862199
25000000,8784318,Kristen Stewart,Walter Salles,137,Adventure,-16215682
25000000,1037335,Harrison Ford,Wayne Kramer,113,Drama,-23962665
25000000,10589102,Nicolas Cage,Werner Herzog,122,Drama,-14410898
25000000,19829957,Max Thieriot,Wes Craven,107,Drama,-5170043
25000000,4644108,Keira Knightley,William Monahan,103,Drama,-20355892
25100000,29506464,Josh Brolin,Oliver Stone,131,Drama,4406464
25485000,29548291,Martin Balsam,Richard Fleischer,144,History,4063291
25500000,2415472,Clive Owen,Guillaume Canet,128,Thriller,-23084528
25530000,20080020,Elijah Wood,Alan Shapiro,95,Adventure,-5449980
26000000,90574188,Will Ferrell,Adam McKay,94,Comedy,64574188
26000000,8009329,Charlie Sheen,Adam Rifkin,89,Comedy,-17990671
26000000,36800000,Christopher Lambert,Andrew Morahan,99,Action,10800000
26000000,65705772,Drew Barrymore,Andy Tennant,121,Drama,39705772
26000000,28780255,Giovanni Ribisi,Ben Younger,118,Crime,2780255
26000000,90426405,Ali Larter,David R. Ellis,90,Horror,64426405
26000000,116400000,Bette Midler,Hugh Wilson,103,Comedy,90400000
26000000,29657751,John Cusack,James McTeigue,111,Thriller,3657751
26000000,181096164,Charlie Sheen,Jim Abrahams,84,Action,155096164
26000000,43318349,Tobey Maguire,Jim Sheridan,104,Drama,17318349
26000000,71000000,George Clooney,Joel Coen,106,Action,45000000
26000000,61489265,Kiefer Sutherland,Joel Schumacher,115,Drama,35489265
26000000,53676580,Shia LaBeouf,John Hillcoat,115,Crime,27676580
26000000,206678440,Tom Hanks,Jonathan Demme,125,Drama,180678440
26000000,38793283,Jesse Bradford,Jonathan Frakes,94,Adventure,12793283
26000000,109449237,Steve Carell,Judd Apatow,116,Comedy,83449237
26000000,17496992,James Franco,Justin Lin,108,Drama,-8503008
26000000,51164106,Vince Vaughn,Ken Scott,105,Comedy,25164106
26000000,28818995,Frankie Muniz,Kevin Allen,100,Comedy,2818995
26000000,110230332,Jamie Lee Curtis,Mark Waters,97,Comedy,84230332
26000000,35926213,Michelle Monaghan,Michael Hoffman,117,Drama,9926213
26000000,19075720,Keanu Reeves,Robert Longo,97,Adventure,-6924280
26000000,124033791,Billy Crystal,Ron Underwood,112,Action,98033791
26000000,67918658,Paul Bettany,Scott Stewart,100,Horror,41918658
26000000,183293131,Kevin James,Steve Carr,91,Action,157293131
26000000,30523226,Ryan Reynolds,Tarsem Singh,116,Science Fiction,4523226
26000000,57891803,Rachel McAdams,Wes Craven,85,Horror,31891803
26350000,1576687,Rebecca Hall,Stephen Frears,94,Drama,-24773313
27000000,27200316,Rufus Sewell,Alex Proyas,100,Mystery,200316
27000000,231976425,Ralph Fiennes,Anthony Minghella,162,Drama,204976425
27000000,25023434,Woody Harrelson,Bobby Farrelly,113,Comedy,-1976566
27000000,16140822,Denzel Washington,Carl Franklin,102,Drama,-10859178
27000000,129000000,Hugh Grant,Chris Weitz,101,Drama,102000000
27000000,29000000,Ren√©e Zellweger,Christian Alvart,109,Horror,2000000
27000000,101624843,Seth Rogen,David Gordon Green,111,Action,74624843
27000000,13000000,Carrie-Anne Moss,E. Elias Merhige,99,Crime,-14000000
27000000,60527873,Morgan Freeman,Gary Fleder,115,Drama,33527873
27000000,28831145,Kevin Costner,Ivan Reitman,109,Drama,1831145
27000000,71320000,Chevy Chase,Jeremiah S. Chechik,97,Comedy,44320000
27000000,115229890,Dan Aykroyd,John Landis,133,Music,88229890
27000000,115505027,Natalie Portman,Mike Nichols,104,Drama,88505027
27000000,161849455,Bradley Cooper,Neil Burger,105,Thriller,134849455
27000000,96900000,William Shatner,Nicholas Meyer,113,Science Fiction,69900000
27000000,56308881,Josh Hartnett,Paul McGuigan,110,Drama,29308881
27000000,38122105,Arnold Schwarzenegger,Paul Michael Glaser,101,Action,11122105
27000000,101646581,Jean-Claude Van Damme,Peter Hyams,99,Thriller,74646581
27000000,21500000,Fred Ward,Philip Kaufman,193,Drama,-5500000
27000000,13670688,Macaulay Culkin,Pixote Hunt,80,Fantasy,-13329312
27000000,21148829,LL Cool J,Renny Harlin,106,Mystery,-5851171
27000000,76000000,Matthew McConaughey,Richard Linklater,113,Crime,49000000
27000000,17286299,Kelan Pannell,Robert B. Weide,110,Comedy,-9713701
27000000,85564310,Jessica Alba,Robert Rodriguez,89,Family,58564310
27000000,14683921,Patrick Swayze,Roland Joff√©,132,Drama,-12316079
27000000,44352417,Alexis Bledel,Sanaa Hamri,117,Adventure,17352417
27000000,56870414,Bill Pullman,Steve Miner,82,Horror,29870414
27000000,16504936,Caitlin Stasey,Stuart Beattie,103,Action,-10495064
27000000,14859394,Meryl Streep,Wes Craven,124,Drama,-12140606
27000000,20158808,Barret Oliver,Wolfgang Petersen,102,Drama,-6841192
27220000,5496951,Nicolas Cage,Scott Walker,105,Thriller,-21723049
27500000,24748670,Omar Metwally,Gavin Hood,120,Drama,-2751330
27500000,183700000,Roger Moore,John Glen,131,Adventure,156200000
28000000,133346506,Christian Bale,Adam McKay,130,Comedy,105346506
28000000,47951979,Robert Redford,Barry Levinson,137,Drama,19951979
28000000,60780981,Ben Stiller,Ben Stiller,89,Comedy,32780981
28000000,41230799,Howard Stern,Betty Thomas,109,Comedy,13230799
28000000,8555008,Benedict Cumberbatch,Bill Condon,128,Drama,-19444992
28000000,45236543,Amber Valletta,Brian Levant,94,Action,17236543
28000000,68896829,Paul Walker,Camille Delamarre,90,Action,40896829
28000000,7002261,Sandra Bullock,David Gordon Green,108,Drama,-20997739
28000000,10126458,Sara Paxton,David R. Ellis,91,Horror,-17873542
28000000,92380927,Seann William Scott,David Wain,99,Comedy,64380927
28000000,11373501,Jodi Benson,Don Bluth,87,Animation,-16626499
28000000,3983912,Martin Short,Don Bluth,74,Animation,-24016088
28000000,38159905,Lindsay Lohan,Donald Petrie,103,Comedy,10159905
28000000,201634991,O'Shea Jackson Jr.,F. Gary Gray,147,Drama,173634991
28000000,64445708,Kurt Russell,Gavin O'Connor,135,Drama,36445708
28000000,58795814,Frankie Muniz,Harald Zwart,102,Action,30795814
28000000,186438883,Joaquin Phoenix,James Mangold,136,Drama,158438883
28000000,8888143,Russell Crowe,Jay Roach,119,Comedy,-19111857
28000000,29000000,Aaron Taylor-Johnson,Jeff Wadlow,103,Action,1000000
28000000,121147947,Keira Knightley,Joe Wright,128,Drama,93147947
28000000,14010832,Natasha Henstridge,John Carpenter,98,Action,-13989168
28000000,195312802,Roger Moore,John Glen,127,Adventure,167312802
28000000,14051384,Dan Aykroyd,John Landis,123,Music,-13948616
28000000,140767956,Bruce Willis,John McTiernan,131,Action,112767956
28000000,134402450,Robert De Niro,Jon Turteltaub,105,Comedy,106402450
28000000,39514713,Bette Midler,Kenny Ortega,96,Comedy,11514713
28000000,97594140,Julianne Hough,Lasse Hallstr√∂m,115,Romance,69594140
28000000,5684789,Tenzin Thuthob Tsarong,Martin Scorsese,134,Drama,-22315211
28000000,96188903,Aaron Taylor-Johnson,Matthew Vaughn,117,Action,68188903
28000000,31596911,Liam Neeson,Michael Caton-Jones,139,Adventure,3596911
28000000,100654149,Steve Carell,Miguel Arteta,81,Family,72654149
28000000,103173635,Harrison Ford,Mike Nichols,114,Comedy,75173635
28000000,16900000,Liam Neeson,Neil Jordan,132,Drama,-11100000
28000000,28208085,Jesse Eisenberg,Nima Nourizadeh,96,Comedy,208085
28000000,33000337,Gerard Butler,Patrick Lussier,99,Horror,5000337
28000000,1021398,Liam Neeson,Paul Haggis,137,Drama,-26978602
28000000,77516304,John Cusack,Peter Chelsom,90,Comedy,49516304
28000000,40400657,Roy Scheider,Peter Hyams,116,Thriller,12400657
28000000,90449929,Kirsten Dunst,Peyton Reed,98,Comedy,62449929
28000000,32768670,Harrison Ford,Ridley Scott,117,Science Fiction,4768670
28000000,504050219,Scott Weinger,Ron Clements,90,Animation,476050219
28000000,40547440,Jesse Eisenberg,Ruben Fleischer,83,Action,12547440
28000000,53181600,Liam Neeson,Scott Frank,113,Crime,25181600
28000000,92601050,Catherine Zeta-Jones,Scott Hicks,104,Comedy,64601050
28000000,333000000,Harrison Ford,Steven Spielberg,118,Adventure,305000000
28000000,102356381,Sarah Polley,Zack Snyder,101,Fantasy,74356381
29000000,33662874,Andy Lau,Benny Chan,131,Action,4662874
29000000,287506194,Anna Kendrick,Elizabeth Banks,115,Comedy,258506194
29000000,309208309,Sandra Bullock,John Lee Hancock,129,Drama,280208309
29000000,21126225,Adrien Brody,John Maybury,103,Drama,-7873775
29000000,115603229,Rachel McAdams,Nick Cassavetes,123,Romance,86603229
29000000,16930185,Matthew Perry,Reginald Hudlin,100,Comedy,-12069815
29000000,98185582,Antonio Banderas,Robert Rodriguez,102,Action,69185582
29000000,50041732,Patricia Arquette,Rupert Wainwright,103,Horror,21041732
29000000,59509925,Bruce Willis,Tony Scott,105,Adventure,30509925
29000000,34994648,Arnold Schwarzenegger,Walter Hill,104,Comedy,5994648
29500000,168840000,Bruce Willis,Terry Gilliam,129,Science Fiction,139340000
30000000,105834556,Jack Nicholson,Alexander Payne,125,Drama,75834556
30000000,108609310,Ioan Gruffudd,Alister Grierson,108,Action,78609310
30000000,14711793,Brad Pitt,Andrew Dominik,160,Action,-15288207
30000000,107597242,Kevin James,Andy Fickman,94,Action,77597242
30000000,180622424,Reese Witherspoon,Andy Tennant,108,Comedy,150622424
30000000,160259319,Katherine Heigl,Anne Fletcher,111,Comedy,130259319
30000000,19204929,Chow Yun-fat,Antoine Fuqua,87,Drama,-10795071
30000000,91709827,Jake Gyllenhaal,Antoine Fuqua,123,Action,61709827
30000000,74787599,Nick Nolte,Barbra Streisand,132,Drama,44787599
30000000,49114016,Warren Beatty,Barry Levinson,134,Drama,19114016
30000000,11146270,Michael J. Fox,Barry Sonnenfeld,94,Comedy,-18853730
30000000,191502426,Ra√∫l Juli√°,Barry Sonnenfeld,99,Comedy,161502426
30000000,136706683,Denzel Washington,Boaz Yakin,113,Drama,106706683
30000000,40346186,Jason Statham,Boaz Yakin,94,Action,10346186
30000000,50451307,Drew Barrymore,Bobby Farrelly,103,Comedy,20451307
30000000,54819301,Sean Hayes,Bobby Farrelly,92,Comedy,24819301
30000000,62616646,Ben Affleck,Brad Furman,91,Crime,32616646
30000000,24048000,Denzel Washington,Brett Leonard,106,Action,-5952000
30000000,36516012,Al Pacino,Brian De Palma,144,Action,6516012
30000000,15007991,Cole Hauser,Bruce Hunt,97,Action,-14992009
30000000,21800302,Bernie Mac,Charles Stone III,104,Comedy,-8199698
30000000,68369434,David Duchovny,Chris Carter,104,Drama,38369434
30000000,64626786,Emile Hirsch,Chris Gorak,89,Horror,34626786
30000000,254134910,Christine Cavanaugh,Chris Noonan,89,Fantasy,224134910
30000000,35078241,Ewan McGregor,Chris Noonan,92,Drama,5078241
30000000,216763646,Clint Eastwood,Clint Eastwood,132,Drama,186763646
30000000,135130999,Kevin Costner,Clint Eastwood,138,Crime,105130999
30000000,23619609,Leelee Sobieski,Daniel Sackheim,106,Drama,-6380391
30000000,34441873,Michael Fassbender,Danny Boyle,122,History,4441873
30000000,27610873,Kuno Becker,Danny Cannon,118,Drama,-2389127
30000000,114281051,Meryl Streep,David Frankel,100,Drama,84281051
30000000,26810113,Justin Chatwin,David S. Goyer,102,Action,-3189887
30000000,75505973,Josh Hartnett,David Slade,113,Horror,45505973
30000000,84025816,Emily Blunt,Denis Villeneuve,121,Action,54025816
30000000,27437881,Steve Carell,Don Scardino,100,Comedy,-2562119
30000000,14000000,Ray Romano,Donald Petrie,110,Comedy,-16000000
30000000,49263404,Jeremy Piven,Doug Ellin,104,Comedy,19263404
30000000,66486080,Kristen Connolly,Drew Goddard,95,Horror,36486080
30000000,967000,Jon Foo,Dwight H. Little,92,Crime,-29033000
30000000,967000,Jon Foo,Dwight H. Little,92,Crime,-29033000
30000000,60864870,Eddie Murphy,Eddie Murphy,116,Action,30864870
30000000,37036004,Ben Stiller,Edward Norton,127,Comedy,7036004
30000000,160638883,Brad Pitt,Edward Zwick,133,Drama,130638883
30000000,102820008,Jake Gyllenhaal,Edward Zwick,112,Drama,72820008
30000000,93772522,Frankie Muniz,Frederik Du Chau,102,Comedy,63772522
30000000,68129518,Thomas Kretschmann,Fyodor Bondarchuk,131,War,38129518
30000000,58405313,Diane Lane,Gary David Goldberg,98,Comedy,28405313
30000000,114663461,Anne Hathaway,Gary Winick,89,Comedy,84663461
30000000,31148328,Edward Norton,Gavin O'Connor,130,Thriller,1148328
30000000,33013805,Sam Rockwell,George Clooney,113,Comedy,3013805
30000000,102616183,Richard Gere,Gregory Hoblit,129,Crime,72616183
30000000,25480490,Mira Sorvino,Guillermo del Toro,105,Fantasy,-4519510
30000000,295212467,Bill Murray,Ivan Reitman,107,Fantasy,265212467
30000000,287553595,Jason Biggs,J.B. Rogers,108,Comedy,257553595
30000000,90259536,John Cusack,James Mangold,90,Mystery,60259536
30000000,350448145,Keanu Reeves,Jan de Bont,116,Action,320448145
30000000,84646831,Sean Maguire,Jason Friedberg,84,Comedy,54646831
30000000,105011053,Tina Fey,Jason Moore,118,Comedy,75011053
30000000,130786397,Liam Neeson,Jaume Collet-Serra,113,Action,100786397
30000000,57400547,Jean-Claude Van Damme,Jean-Claude Van Damme,95,Action,27400547
30000000,35294470,Ethan Hawke,Jean-Fran√ßois Richet,109,Thriller,5294470
30000000,129266061,Keira Knightley,Joe Wright,123,Drama,99266061
30000000,63782078,Saoirse Ronan,Joe Wright,111,Action,33782078
30000000,77566815,Jim Carrey,Joel Schumacher,101,Thriller,47566815
30000000,152427960,Roger Moore,John Glen,131,Adventure,122427960
30000000,361958736,Tom Hanks,John Lasseter,81,Animation,331958736
30000000,51376861,Robin Shou,John R. Leonetti,95,Action,21376861
30000000,13130349,Ving Rhames,John Singleton,140,Drama,-16869651
30000000,16930884,Al Pacino,Jon Avnet,108,Crime,-13069116
30000000,159291809,Rick Malambri,Jon M. Chu,107,Drama,129291809
30000000,219076518,Seth Rogen,Judd Apatow,129,Comedy,189076518
30000000,45554533,Jim Cummings,Jun Falkenstein,77,Animation,15554533
30000000,55583804,Bruce Willis,Kevin Smith,107,Action,25583804
30000000,82394288,Chlo√´ Grace Moretz,Kimberly Peirce,100,Drama,52394288
30000000,31070211,Milla Jovovich,Kurt Wimmer,88,Science Fiction,1070211
30000000,18618284,Robert Redford,Lasse Hallstr√∂m,108,Drama,-11381716
30000000,34742066,Antonio Banderas,Liz Friedlander,108,Music,4742066
30000000,36894225,Robert De Niro,Luc Besson,111,Crime,6894225
30000000,6916869,Charlize Theron,Luis Mandoki,106,Action,-23083131
30000000,2527904,Gerard Butler,Marc Forster,129,Action,-27472096
30000000,53653224,Will Ferrell,Marc Forster,113,Comedy,23653224
30000000,38413606,Robert De Niro,Martin Brest,126,Adventure,8413606
30000000,611899420,Jim Caviezel,Mel Gibson,127,Drama,581899420
30000000,63833449,Tina Fey,Michael McCullers,99,Comedy,33833449
30000000,196114570,Rachel McAdams,Michael Sucsy,104,Drama,166114570
30000000,13521829,Hayden Panettiere,Mike Disa,86,Comedy,-16478171
30000000,495303,Luke Wilson,Mike Judge,84,Adventure,-29504697
30000000,22211426,Rhona Mitra,Neil Marshall,105,Action,-7788574
30000000,210819611,Sharlto Copley,Neill Blomkamp,112,Action,180819611
30000000,53909751,Emily Blunt,Nicholas Stoller,124,Comedy,23909751
30000000,105173115,Jason Segel,Nicholas Stoller,111,Comedy,75173115
30000000,95714875,Cameron Diaz,Nick Cassavetes,109,Drama,65714875
30000000,42886719,Ashton Kutcher,Nigel Cole,107,Comedy,12886719
30000000,108979549,Jason Statham,Olivier Megaton,104,Action,78979549
30000000,51148651,Russell Crowe,Paul Haggis,133,Romance,21148651
30000000,13001257,Josh Hartnett,Paul McGuigan,114,Drama,-16998743
30000000,251495,Stellan Skarsg√•rd,Paul Schrader,117,Horror,-29748505
30000000,61255921,Billy Bob Thornton,Peter Berg,118,Drama,31255921
30000000,9898412,Jon Favreau,Peter Berg,100,Comedy,-20101588
30000000,17833000,Ryan Phillippe,Peter Howitt,108,Action,-12167000
30000000,29359216,Michael J. Fox,Peter Jackson,110,Horror,-640784
30000000,51132598,Leslie Nielsen,Peter Segal,83,Comedy,21132598
30000000,20348249,Colin Farrell,Peter Weir,133,Drama,-9651751
30000000,41480851,Dwayne Johnson,Phil Joanou,125,Action,11480851
30000000,27674124,Michael Caine,Phillip Noyce,101,Drama,-2325876
30000000,180949000,Uma Thurman,Quentin Tarantino,111,Action,150949000
30000000,152159461,Uma Thurman,Quentin Tarantino,136,Action,122159461
30000000,173959438,Martin Lawrence,Raja Gosnell,98,Crime,143959438
30000000,47042000,Joseph Gordon-Levitt,Rian Johnson,118,Action,17042000
30000000,8454301,Paul Giamatti,Richard J. Lewis,134,Comedy,-21545699
30000000,33333531,Cameron Diaz,Richard Kelly,115,Thriller,3333531
30000000,156835339,Hilary Swank,Richard LaGravenese,126,Drama,126835339
30000000,34252847,Billy Bob Thornton,Richard Linklater,113,Comedy,4252847
30000000,45892212,Michael Douglas,Ridley Scott,125,Action,15892212
30000000,15368897,Luke Wilson,Rob Reiner,96,Comedy,-14631103
30000000,25312387,Michael Douglas,Rob Reiner,94,Comedy,-4687613
30000000,114908830,Robert Englund,Ronny Yu,97,Horror,84908830
30000000,15556340,Christopher Lambert,Russell Mulcahy,91,Action,-14443660
30000000,90842646,Alison Lohman,Sam Raimi,99,Horror,60842646
30000000,48428063,Elijah Wood,Shane Acker,79,Action,18428063
30000000,82150642,Cate Blanchett,Shekhar Kapur,124,Drama,52150642
30000000,4861022,Josh Brolin,Spike Lee,104,Drama,-25138978
30000000,14460000,Jim Cummings,Stephen Anderson,63,Animation,-15540000
30000000,47126295,John Cusack,Stephen Frears,113,Comedy,17126295
30000000,53898845,Charlie Sheen,Stephen Herek,105,Action,23898845
30000000,140161792,Tom Kenny,Stephen Hillenburg,87,Animation,110161792
30000000,192452832,Peter Sallis,Steve Box,85,Adventure,162452832
30000000,212385533,Jim Carrey,Steve Oedekerk,90,Comedy,182385533
30000000,63372757,Rooney Mara,Steven Soderbergh,106,Thriller,33372757
30000000,30536013,Colin Farrell,Terrence Malick,135,Drama,536013
30000000,61808775,Christopher Plummer,Terry Gilliam,123,Adventure,31808775
30000000,76669806,Samuel L. Jackson,Thomas Carter,136,Drama,46669806
30000000,36160375,Tom Hanks,Tom Hanks,98,Comedy,6160375
30000000,13273595,Madonna,Uli Edel,99,Drama,-16726405
30000000,25473093,Jennifer Connelly,Walter Salles,105,Drama,-4526907
30000000,29202884,Warren Beatty,Warren Beatty,108,Comedy,-797116
30000000,174600318,Ralph Fiennes,Wes Anderson,99,Comedy,144600318
30000000,70200000,William Shatner,William Shatner,107,Science Fiction,40200000
30000000,151119219,Owen Wilson,Woody Allen,94,Fantasy,121119219
30250000,115101622,John Travolta,Barry Sonnenfeld,105,Comedy,84851622
31000000,231605150,Whoopi Goldberg,Emile Ardolino,100,Music,200605150
31000000,68106245,Dennis Quaid,Gregory Hoblit,118,Crime,37106245
31000000,104384188,Ed Helms,John Francis Daley,99,Adventure,73384188
31000000,28000000,James Franco,Kevin Reynolds,125,Drama,-3000000
31000000,134095253,Al Pacino,Martin Brest,157,Drama,103095253
31000000,35419397,Cher,Richard Benjamin,110,Comedy,4419397
31000000,41512007,Kirsten Dunst,Richard Loncraine,98,Comedy,10512007
31000000,161772375,Denzel Washington,Robert Zemeckis,138,Drama,130772375
31000000,24185781,Anthony Hopkins,Scott Hicks,101,Drama,-6814219
31000000,74134790,Richard Dreyfuss,Steven Spielberg,122,Fantasy,43134790
31000000,128499205,Meryl Streep,Sydney Pollack,161,Drama,97499205
31000000,300473716,Sylvester Stallone,Sylvester Stallone,91,Drama,269473716
31000000,15134293,Harrison Ford,Tom Vaughan,105,Drama,-15865707
31000000,27388767,Anne Hathaway,Tommy O'Haver,96,Fantasy,-3611233
31115000,57750000,Elizabeth Taylor,Joseph L. Mankiewicz,248,Drama,26635000
31500000,83471511,Martin Sheen,Francis Ford Coppola,153,Drama,51971511
32000000,97918663,Ice Cube,Brian Levant,95,Comedy,65918663
32000000,40222729,Keanu Reeves,Brian Robbins,106,Comedy,8222729
32000000,60740827,Viggo Mortensen,David Cronenberg,96,Drama,28740827
32000000,147332697,Jake Gyllenhaal,Duncan Jones,93,Thriller,115332697
32000000,51155219,Daniel Craig,Edward Zwick,137,Action,19155219
32000000,36733909,Ethan Hawke,Frank Marshall,120,Action,4733909
32000000,16283667,Jonathan Brandis,George T. Miller,89,Drama,-15716333
32000000,48814909,Robert De Niro,"George Tillman, Jr.",129,Drama,16814909
32000000,80197993,Jack Black,Jared Hess,92,Comedy,48197993
32000000,222724172,Rick Moranis,Joe Johnston,93,Adventure,190724172
32000000,156167015,Timothy Dalton,John Glen,133,Adventure,124167015
32000000,27635305,Viggo Mortensen,John Hillcoat,111,Adventure,-4364695
32000000,69055695,Chris Brown,John Luessenhop,107,Action,37055695
32000000,83615414,Portia Doubleday,John Whitesell,107,Crime,51615414
32000000,173398518,Will Ferrell,Jon Favreau,97,Romance,141398518
32000000,152036382,John Travolta,Jon Turteltaub,123,Drama,120036382
32000000,85167639,Jason Statham,Louis Leterrier,87,Action,53167639
32000000,3566637,Scott Bakula,Mark Dindal,75,Animation,-28433363
32000000,55157539,Richard Gere,Mark Pellington,119,Drama,23157539
32000000,18409891,Jude Law,Miguel Sapochnik,111,Action,-13590109
32000000,52277485,Cuba Gooding Jr.,Mike Tollin,109,Drama,20277485
32000000,42045846,Drew Barrymore,Nanette Burstein,102,Comedy,10045846
32000000,28258060,Joaquin Phoenix,Paul Thomas Anderson,137,Drama,-3741940
32000000,57284237,Tom Payne,Philipp St√∂lzl,155,Adventure,25284237
32000000,79082515,Alex D. Linz,Raja Gosnell,102,Comedy,47082515
32000000,18552460,Sharon Stone,Sam Raimi,107,Action,-13447540
32000000,126041322,James Franco,Seth Rogen,107,Action,94041322
32000000,5914908,George Clooney,Steven Soderbergh,108,War,-26085092
32000000,54674226,Brad Pitt,Terrence Malick,139,Drama,22674226
32000000,50907422,Trey Parker,Trey Parker,98,Music,18907422
32000000,40382659,Warren Beatty,Warren Beatty,195,Drama,8382659
32350000,572700000,Mark Hamill,Richard Marquand,135,Adventure,540350000
32500000,288383523,Kristen Wiig,Paul Feig,125,Romance,255883523
33000000,244386864,Jackie Chan,Brett Ratner,98,Action,211386864
33000000,20645327,Ben Foster,Christian Alvart,108,Action,-12354673
33000000,269958228,Clint Eastwood,Clint Eastwood,116,Drama,236958228
33000000,327311859,Brad Pitt,David Fincher,127,Crime,294311859
33000000,62022014,Samuel L. Jackson,David R. Ellis,105,Horror,29022014
33000000,310940086,Mike Myers,Jay Roach,95,Crime,277940086
33000000,9494789,Kyle Catlett,Jean-Pierre Jeunet,105,Adventure,-23505211
33000000,54700105,Thomas Jane,Jonathan Hensleigh,124,Action,21700105
33000000,1132112,Colin Firth,Milo≈° Forman,137,Drama,-31867888
33000000,102441078,Milla Jovovich,Paul W.S. Anderson,100,Horror,69441078
33000000,140470746,Kathryn McCormick,Scott Speer,99,Music,107470746
33000000,104155843,Jennifer Lopez,Tarsem Singh,107,Horror,71155843
34000000,4217115,Giuseppe Andrews,Adam Rifkin,95,Comedy,-29782885
34000000,63013281,Scott Eastwood,"George Tillman, Jr.",128,Romance,29013281
34000000,95608995,Chris Evans,Kevin Munroe,90,Comedy,61608995
34000000,210300000,Roger Moore,Lewis Gilbert,126,Action,176300000
34000000,32255440,Daniel Day-Lewis,Martin Scorsese,139,Drama,-1744560
34000000,19693891,Freddie Prinze Jr.,Mike Tollin,108,Drama,-14306109
34000000,50282766,Woody Harrelson,Oliver Stone,119,Crime,16282766
34000000,48169908,Denzel Washington,Spike Lee,202,Drama,14169908
34000000,348319861,Dylan O'Brien,Wes Ball,113,Action,314319861
34200000,234801895,Adam Sandler,Dennis Dugan,93,Comedy,200601895
35000000,94728529,Jennifer Lopez,Adam Shankman,103,Comedy,59728529
35000000,77477008,Jennifer Lopez,Alan Poul,106,Comedy,42477008
35000000,74558115,Johnny Depp,Albert Hughes,122,Horror,39558115
35000000,82347656,Rupert Friend,Aleksander Bach,96,Action,47347656
35000000,72436439,Kiefer Sutherland,Alexandre Aja,110,Horror,37436439
35000000,156563139,Steven Seagal,Andrew Davis,103,Action,121563139
35000000,51680201,Reese Witherspoon,Anne Fletcher,87,Action,16680201
35000000,791830,Sophie Marceau,Bernard Rose,108,Drama,-34208170
35000000,4858139,Keanu Reeves,Bernardo Bertolucci,140,Drama,-30141861
35000000,16838910,Rebecca Romijn,Brian De Palma,114,Thriller,-18161090
35000000,11560806,Heath Ledger,Brian Helgeland,102,Drama,-23439194
35000000,31611225,Tim Allen,Bryan Spicer,115,Comedy,-3388775
35000000,25105255,John Cusack,Clint Eastwood,155,Crime,-9894745
35000000,84606030,Leonardo DiCaprio,Clint Eastwood,137,Drama,49606030
35000000,15185241,Justin Whalin,Courtney Solomon,107,Action,-19814759
35000000,25871834,Drake Bell,Craig Mazin,85,Action,-9128166
35000000,126216940,Kevin Spacey,Curtis Hanson,138,Crime,91216940
35000000,30526509,Al Pacino,D.J. Caruso,122,Comedy,-4473491
35000000,15304890,Hugh Jackman,Darren Aronofsky,96,Drama,-19695110
35000000,17508518,Arnold Schwarzenegger,David Ayer,110,Action,-17491482
35000000,326551094,Meryl Streep,David Frankel,109,Comedy,291551094
35000000,31083599,Joseph Gordon-Levitt,David Koepp,91,Crime,-3916401
35000000,24159934,Paul Rudd,David Wain,98,Comedy,-10840066
35000000,36779296,Ben Affleck,Don Roos,106,Drama,1779296
35000000,63710000,Bill Murray,Frank Oz,100,Comedy,28710000
35000000,19478106,Ewan McGregor,Gary Chapman,76,Animation,-15521894
35000000,95437994,Sam Rockwell,Gil Kenan,93,Horror,60437994
35000000,32483410,Diane Lane,Gregory Hoblit,101,Drama,-2516590
35000000,40263020,Brendan Fraser,Hugh Wilson,112,Comedy,5263020
35000000,45681173,Peter Weller,Irvin Kershner,117,Action,10681173
35000000,18317151,John C. Reilly,Jake Kasdan,96,Comedy,-16682849
35000000,27409889,Emily Blunt,Jean-Marc Vall√©e,105,Drama,-7590111
35000000,15000000,Juliette Binoche,Jean-Paul Rappeneau,135,War,-20000000
35000000,23562716,Sylvester Stallone,John Landis,109,Action,-11437284
35000000,112544580,Emma Thompson,John Lee Hancock,125,Comedy,77544580
35000000,85416905,Mark Wahlberg,John Moore,100,Action,50416905
35000000,82087155,Taylor Lautner,John Singleton,106,Thriller,47087155
35000000,116980662,Nicholas Hoult,Jonathan Levine,97,Horror,81980662
35000000,140795793,Amy Schumer,Judd Apatow,125,Comedy,105795793
35000000,88058786,Paul Rudd,Judd Apatow,134,Comedy,53058786
35000000,27330000,Idris Elba,Justin Chadwick,141,Drama,-7670000
35000000,21819348,Robert De Niro,Justin Zackham,90,Comedy,-13180652
35000000,69307224,Robin Williams,Ken Kwapis,91,Comedy,34307224
35000000,14431253,Vince Vaughn,Ken Scott,90,Comedy,-20568747
35000000,68915888,Bernie Mac,Kevin Rodney Sullivan,105,Comedy,33915888
35000000,36098382,Ben Affleck,Kevin Smith,102,Comedy,1098382
35000000,13678913,Colin Farrell,Les Mayfield,94,Action,-21321087
35000000,59901913,Kate Hudson,Luke Greenfield,112,Comedy,24901913
35000000,43650785,Martin Lawrence,Malcolm D. Lee,114,Comedy,8650785
35000000,182300000,Robert De Niro,Martin Scorsese,128,Crime,147300000
35000000,28128670,Mary Elizabeth Winstead,Matthijs van Heijningen Jr.,103,Horror,-6871330
35000000,35323292,Walter Matthau,Michael Ritchie,102,Comedy,323292
35000000,45479110,Stuart Townsend,Michael Rymer,101,Drama,10479110
35000000,27107960,Sam J. Jones,Mike Hodges,111,Science Fiction,-7892040
35000000,86369815,Michael Angarano,Mike Mitchell,100,Adventure,51369815
35000000,41954997,Johnny Depp,Mike Newell,127,Crime,6954997
35000000,194564672,Robert De Niro,Nancy Meyers,121,Comedy,159564672
35000000,117270765,Walter Matthau,Nick Castle,94,Family,82270765
35000000,22034832,Brittany Murphy,Nick Hurran,111,Comedy,-12965168
35000000,25224242,Charlize Theron,Niki Caro,126,Drama,-9775758
35000000,91327197,Bill Nighy,Patrick Tatopoulos,92,Fantasy,56327197
35000000,155545279,Miley Cyrus,Peter Chelsom,102,Comedy,120545279
35000000,12506188,Tim Allen,Peter Hewitt,83,Fantasy,-22493812
35000000,64350171,Jean-Claude Van Damme,Peter Hyams,106,Action,29350171
35000000,48623572,Will Smith,Peter Landesman,123,Drama,13623572
35000000,20298207,Ren√©e Zellweger,Peyton Reed,101,Action,-14701793
35000000,60251371,Diane Lane,Randall Wallace,123,Drama,25251371
35000000,42930462,Dwayne Johnson,Ric Roman Waugh,112,Thriller,7930462
35000000,4651977,Elijah Wood,Richard Donner,114,Drama,-30348023
35000000,321731527,Mel Gibson,Richard Donner,118,Adventure,286731527
35000000,131282949,Jack Black,Richard Linklater,108,Comedy,96282949
35000000,9771658,Michelle Nicastro,Richard Rich,90,Fantasy,-25228342
35000000,42064105,Russell Crowe,Ridley Scott,118,Comedy,7064105
35000000,69823199,Jim Sturgess,Robert Luketic,123,Drama,34823199
35000000,13785015,Liam Hemsworth,Robert Luketic,106,Drama,-21214985
35000000,63215872,Robert Redford,Robert Redford,92,Action,28215872
35000000,147934180,Alexa PenaVega,Robert Rodriguez,88,Action,112934180
35000000,139000000,William Shatner,Robert Wise,132,Science Fiction,104000000
35000000,61181942,Joseph Gordon-Levitt,Robert Zemeckis,123,Adventure,26181942
35000000,113000000,Natasha Henstridge,Roger Donaldson,108,Science Fiction,78000000
35000000,39340177,Brendan Fraser,Roger Kumble,92,Comedy,4340177
35000000,120072577,Adrien Brody,Roman Polanski,150,Drama,85072577
35000000,57269863,Warwick Davis,Ron Howard,126,Adventure,22269863
35000000,137935567,Michael B. Jordan,Ryan Coogler,133,Drama,102935567
35000000,75225693,Leonardo DiCaprio,Sam Mendes,119,Drama,40225693
35000000,115664037,Jackie Earle Haley,Samuel Bayer,95,Horror,80664037
35000000,29400000,Jack Nicholson,Sean Penn,123,Crime,-5600000
35000000,173965010,Jason Bateman,Seth Gordon,111,Comedy,138965010
35000000,117000000,Jennifer Aniston,Seth Gordon,98,Comedy,82000000
35000000,29882645,Heath Ledger,Shekhar Kapur,132,War,-5117355
35000000,2106557,Nicolas Cage,Simon West,96,Action,-32893443
35000000,57120318,Kevin Peter Hall,Stephen Hopkins,108,Science Fiction,22120318
35000000,68349884,Gabriel Byrne,Steve Beck,91,Horror,33349884
35000000,99423521,Jean-Claude Van Damme,Steven E. de Souza,102,Action,64423521
35000000,31755742,Dan Aykroyd,Steven Spielberg,113,Action,-3244258
35000000,93246388,Emma Thompson,Susanna White,109,Fantasy,58246388
35000000,46216641,Jason Statham,Taylor Hackford,118,Action,11216641
35000000,73034460,Emma Roberts,Thor Freudenthal,100,Comedy,38034460
35000000,411348924,Jack Nicholson,Tim Burton,126,Fantasy,376348924
35000000,459270619,Bradley Cooper,Todd Phillips,100,Comedy,424270619
35000000,170000000,Ashton Kutcher,Tom Vaughan,99,Comedy,135000000
35000000,92219310,Robin Williams,Walt Becker,88,Comedy,57219310
35000000,18635620,Jason Patric,Walter Hill,115,Action,-16364380
35000000,19294901,Portia de Rossi,Wes Craven,97,Horror,-15705099
35000000,150483765,Justin Timberlake,Will Gluck,109,Comedy,115483765
36000000,12532777,Ethan Hawke,Andrew Niccol,106,Thriller,-23467223
36000000,83160734,Owen Wilson,Bobby Farrelly,105,Comedy,47160734
36000000,52424533,Morgan Freeman,Charles Martin Smith,107,Family,16424533
36000000,33459416,Mara Wilson,Danny DeVito,98,Comedy,-2540584
36000000,44350926,Vin Diesel,F. Gary Gray,109,Action,8350926
36000000,160000000,Sean Connery,Irvin Kershner,134,Adventure,124000000
36000000,9612469,Nicolas Cage,Joel Schumacher,91,Crime,-26387531
36000000,50159144,Kurt Russell,Jonathan Mostow,95,Drama,14159144
36000000,189712432,James McAvoy,Kelly Asbury,84,Animation,153712432
36000000,20300385,Woody Harrelson,Milo≈° Forman,129,Drama,-15699615
36000000,102244770,Denzel Washington,Nick Cassavetes,116,Drama,66244770
36000000,64572262,John Cusack,Steve Pink,101,Science Fiction,28572262
36000000,74000000,Morgan Freeman,Steven Spielberg,155,Drama,38000000
37000000,154026136,Ben Affleck,Ben Affleck,125,Crime,117026136
37000000,26250020,Bradley Cooper,Cameron Crowe,105,Adventure,-10749980
37000000,392616625,Kristen Stewart,Catherine Hardwicke,122,Adventure,355616625
37000000,95404397,Morgan Freeman,Charles Martin Smith,113,Drama,58404397
37000000,163720069,George Clooney,Ethan Coen,96,Comedy,126720069
37000000,165335153,Anne Hathaway,Garry Marshall,115,Comedy,128335153
37000000,96455697,Jennifer Garner,Gary Winick,98,Comedy,59455697
37000000,215394738,Bill Murray,Ivan Reitman,108,Fantasy,178394738
37000000,6482195,Dennis Quaid,Jeb Stuart,118,Action,-30517805
37000000,100076342,Abigail Breslin,Jennifer Flackett,96,Adventure,63076342
37000000,113086475,Shawn Wayans,Keenen Ivory Wayans,109,Comedy,76086475
37000000,63800345,Andy Samberg,Kirk De Micco,81,Animation,26800345
37000000,96047633,Anthony Hopkins,Mikael H√•fstr√∂m,114,Drama,59047633
37000000,48451803,Julianne Moore,Paul Thomas Anderson,188,Drama,11451803
37000000,269994119,Jason Sudeikis,Rawson Marshall Thurber,110,Comedy,232994119
37000000,37962774,Lea Thompson,Willard Huyck,110,Fantasy,962774
37665000,14655628,Samuel L. Jackson,Joe Roth,113,Drama,-23009372
37931000,27931461,Bob Newhart,Hendel Butoy,77,Adventure,-9999539
38000000,266614059,Robert Redford,Adrian Lyne,117,Drama,228614059
38000000,635096,Tobey Maguire,Ang Lee,138,Drama,-37364904
38000000,57319029,Whoopi Goldberg,Bill Duke,107,Music,19319029
38000000,120000000,Patrick Stewart,David Carson,118,Science Fiction,82000000
38000000,5410749,Ryan Cartwright,David Leland,93,Adventure,-32589251
38000000,98337295,Vin Diesel,David Twohy,119,Science Fiction,60337295
38000000,252276927,Jeff Bridges,Ethan Coen,110,Drama,214276927
38000000,114156230,Robert Pattinson,Francis Lawrence,120,Drama,76156230
38000000,122417389,Nathan Lane,Gore Verbinski,98,Comedy,84417389
38000000,105610124,Katherine Heigl,Greg Berlanti,115,Comedy,67610124
38000000,28921264,Miriam Margolyes,Henry Selick,79,Adventure,-9078736
38000000,29907685,Kristen Bell,Jim Sonzero,90,Horror,-8092315
38000000,17380126,Hugh Grant,Michael Apted,118,Drama,-20619874
38000000,51801187,Jennifer Lopez,Michael Apted,114,Action,13801187
38000000,34416893,Val Kilmer,Oliver Stone,140,Drama,-3583107
38000000,299288605,Julia Roberts,P.J. Hogan,105,Comedy,261288605
38000000,45465299,Dakota Fanning,Paul McGuigan,111,Action,7465299
38000000,10300000,Jeff Bridges,Ridley Scott,129,Action,-27700000
38000000,207283925,Paul Walker,Rob Cohen,106,Action,169283925
38000000,205298907,Katherine Heigl,Robert Luketic,96,Comedy,167298907
38000000,119723358,Antonio Banderas,Robert Rodriguez,100,Action,81723358
38000000,197011982,Antonio Banderas,Robert Rodriguez,84,Action,159011982
38000000,58401898,Johnny Depp,Roman Polanski,133,Horror,20401898
38000000,90247624,Daniel Br√ºhl,Ron Howard,123,Drama,52247624
38000000,28121100,Michelle Pfeiffer,Ulu Grosbard,106,Drama,-9878900
38000000,153518974,Eddie Murphy,Walter Hill,95,Thriller,115518974
39000000,6614280,Meg Ryan,Charles S. Dutton,106,Romance,-32385720
39000000,288752301,Eddie Murphy,John Landis,116,Comedy,249752301
39000000,38869464,Nathan Fillion,Joss Whedon,119,Science Fiction,-130536
39000000,26820641,Clive Owen,Michael Davis,86,Action,-12179359
39000000,75800000,Christopher Reeve,Richard Lester,125,Comedy,36800000
39000000,101229792,Eric Bana,Robert Schwentke,107,Drama,62229792
39000000,81491068,Charlie Tahan,Tim Burton,87,Animation,42491068
40000000,114830111,Keanu Reeves,Alejandro Agresti,99,Romance,74830111
40000000,173930596,Justin Timberlake,Andrew Niccol,109,Action,133930596
40000000,136000000,Gerard Butler,Andy Tennant,110,Action,96000000
40000000,317375031,Sandra Bullock,Anne Fletcher,108,Comedy,277375031
40000000,41863726,Seth Rogen,Anne Fletcher,95,Comedy,1863726
40000000,128798265,Matt Damon,Anthony Minghella,139,Thriller,88798265
40000000,8493890,Tim Allen,Barry Sonnenfeld,85,Action,-31506110
40000000,141069860,Gwyneth Paltrow,Bobby Farrelly,114,Comedy,101069860
40000000,169837010,Jim Carrey,Bobby Farrelly,110,Comedy,129837010
40000000,85412898,Matthew McConaughey,Brad Furman,119,Crime,45412898
40000000,95020213,Chadwick Boseman,Brian Helgeland,128,Drama,55020213
40000000,22044277,Eddie Murphy,Brian Robbins,91,Drama,-17955723
40000000,74597643,Brendan Fraser,Callan Brunker,89,Animation,34597643
40000000,31670620,Anthony Rapp,Chris Columbus,135,Comedy,-8329380
40000000,30199105,Wesley Snipes,Christian Duguay,117,Action,-9800895
40000000,109676311,Hugh Jackman,Christopher Nolan,130,Drama,69676311
40000000,67347013,Christopher Walken,Clint Eastwood,134,Music,27347013
40000000,41797066,Steven Pasquale,Colin Strause,94,Fantasy,1797066
40000000,8479793,Chevy Chase,Dan Aykroyd,94,Comedy,-31520207
40000000,144056873,Leonardo DiCaprio,Danny Boyle,119,Drama,104056873
40000000,19322135,Ben Stiller,Danny DeVito,89,Action,-20677865
40000000,285176741,Owen Wilson,David Dobkin,119,Comedy,245176741
40000000,224920315,Jesse Eisenberg,David Fincher,120,Drama,184920315
40000000,92913171,Johnny Depp,David Koepp,96,Thriller,52913171
40000000,30925690,Kyle MacLachlan,David Lynch,137,Action,-9074310
40000000,251171807,Christian Bale,David O. Russell,138,Drama,211171807
40000000,186167139,Bobby Campo,David R. Ellis,82,Horror,146167139
40000000,36037909,Meg Ryan,Diane Keaton,94,Comedy,-3962091
40000000,12206028,Kate Beckinsale,Dominic Sena,101,Action,-27793972
40000000,88100000,Nicolas Cage,Dominic Sena,95,Adventure,48100000
40000000,106511453,Will Ferrell,Etan Cohen,100,Comedy,66511453
40000000,215862692,Gary Oldman,Francis Ford Coppola,128,Romance,175862692
40000000,45916769,Matt Damon,Francis Ford Coppola,135,Drama,5916769
40000000,123494610,Drew Barrymore,Frank Coraci,117,Comedy,83494610
40000000,120455994,Paul Walker,Frank Marshall,120,Adventure,80455994
40000000,95149435,Anne Hathaway,Garry Marshall,113,Comedy,55149435
40000000,9793496,Rob Brown,Gary Fleder,130,Drama,-30206504
40000000,23937870,Alex Pettyfer,Geoffrey Sax,93,Adventure,-16062130
40000000,97552050,Seth Rogen,Greg Mottola,104,Adventure,57552050
40000000,357852395,Jaden Smith,Harald Zwart,140,Action,317852395
40000000,26155781,Bruce Willis,Howard Deutch,98,Comedy,-13844219
40000000,126069509,Cameron Diaz,Jake Kasdan,97,Comedy,86069509
40000000,60462347,Rain,James McTeigue,99,Action,20462347
40000000,45735397,Russell Brand,Jason Winer,110,Comedy,5735397
40000000,68766121,Elisha Cuthbert,Jaume Collet-Serra,113,Horror,28766121
40000000,5446000,Mark Strong,Jean-Jacques Annaud,130,Adventure,-34554000
40000000,46442528,50 Cent,Jim Sheridan,117,Drama,6442528
40000000,54682547,Gregory Smith,Joe Dante,110,Comedy,14682547
40000000,152266007,Matthew McConaughey,Joel Schumacher,149,Crime,112266007
40000000,96618699,Nicolas Cage,Joel Schumacher,123,Thriller,56618699
40000000,14358033,Chevy Chase,John Carpenter,99,Action,-25641967
40000000,191185897,Timothy Dalton,John Glen,130,Action,151185897
40000000,91753202,Owen Wilson,John Moore,106,Action,51753202
40000000,138259062,Martin Lawrence,John Whitesell,99,Comedy,98259062
40000000,46546197,Martin Henderson,Joseph Kahn,84,Action,6546197
40000000,36893721,Katherine Heigl,Julie Anne Robinson,91,Action,-3106279
40000000,132820716,Jessica Chastain,Kathryn Bigelow,157,Thriller,92820716
40000000,24719215,Drew Barrymore,Ken Kwapis,107,Adventure,-15280785
40000000,177259441,Jennifer Aniston,Ken Kwapis,129,Comedy,137259441
40000000,79700000,Cameron Diaz,Kirk Jones,110,Romance,39700000
40000000,463360063,Scarlett Johansson,Luc Besson,89,Action,423360063
40000000,672806292,Bruce Willis,M. Night Shyamalan,107,Mystery,632806292
40000000,145896422,Drew Barrymore,Marc Lawrence,96,Comedy,105896422
40000000,87840042,Michael Jai White,Mark A.Z. Dipp√©,96,Action,47840042
40000000,141591324,Halle Berry,Mathieu Kassovitz,98,Horror,101591324
40000000,120175290,Rudy Youngblood,Mel Gibson,139,Thriller,80175290
40000000,22433915,Robert De Niro,Michael Caton-Jones,108,Drama,-17566085
40000000,75505856,Daniel Day-Lewis,Michael Mann,112,Action,35505856
40000000,55707411,Kevin Spacey,Mimi Leder,122,Drama,15707411
40000000,19258519,Hilary Swank,Mira Nair,111,Drama,-20741481
40000000,86915017,Edward Norton,Neil Burger,110,Fantasy,46915017
40000000,38755073,Nicolas Cage,Neil LaBute,102,Mystery,-1244927
40000000,90029656,Jonah Hill,Nicholas Stoller,109,Comedy,50029656
40000000,196781193,Cameron Diaz,Nick Cassavetes,109,Comedy,156781193
40000000,126248813,Topher Grace,Nimr√≥d Antal,107,Action,86248813
40000000,129540499,Meryl Streep,Nora Ephron,123,Romance,89540499
40000000,205405498,Kevin Costner,Oliver Stone,189,Drama,165405498
40000000,60965854,Zoe Saldana,Olivier Megaton,108,Action,20965854
40000000,108332743,Isla Fisher,P.J. Hogan,104,Comedy,68332743
40000000,65754228,Keanu Reeves,Pat O'Connor,119,Drama,25754228
40000000,34227298,James McAvoy,Paul McGuigan,109,Drama,-5772702
40000000,84601681,Patrick Dempsey,Paul Weiland,101,Comedy,44601681
40000000,28169671,John C. Reilly,Paul Weitz,109,Adventure,-11830329
40000000,24332324,Danny DeVito,Penny Marshall,128,Comedy,-15667676
40000000,48093211,Denzel Washington,Penny Marshall,124,Fantasy,8093211
40000000,107458785,Tom Hanks,Penny Marshall,128,Comedy,67458785
40000000,151161491,Dennis Quaid,Pete Travis,90,Drama,111161491
40000000,149295601,Mark Wahlberg,Peter Berg,121,Action,109295601
40000000,160583018,Rowan Atkinson,Peter Howitt,88,Adventure,120583018
40000000,27053815,Catherine Deneuve,Peter Hyams,104,Action,-12946185
40000000,44907260,Robert De Niro,Peter Segal,113,Comedy,4907260
40000000,116300000,Sharon Stone,Phillip Noyce,108,Drama,76300000
40000000,10664749,Sean Penn,Pierre Morel,115,Action,-29335251
40000000,58662452,Rick Moranis,Randal Kleiser,89,Adventure,18662452
40000000,70100000,Eddie Murphy,Reginald Hudlin,117,Drama,30100000
40000000,244931766,Bill Nighy,Richard Curtis,135,Comedy,204931766
40000000,19726050,Bruce Willis,Richard Rush,121,Thriller,-20273950
40000000,49627779,Marlon Brando,Richard Stanley,96,Fantasy,9627779
40000000,243240178,Tom Cruise,Rob Reiner,138,Drama,203240178
40000000,158733820,Jessica Alba,Robert Rodriguez,124,Action,118733820
40000000,28972508,Jimmy Bennett,Robert Rodriguez,89,Comedy,-11027492
40000000,332000000,Michael J. Fox,Robert Zemeckis,108,Adventure,292000000
40000000,244527583,Michael J. Fox,Robert Zemeckis,118,Adventure,204527583
40000000,58785180,Rachel McAdams,Roger Michell,102,Comedy,18785180
40000000,1641825,Walter Matthau,Roman Polanski,124,Adventure,-38358175
40000000,211343479,Jodi Benson,Ron Clements,83,Animation,171343479
40000000,569651467,Dakota Johnson,Sam Taylor-Johnson,125,Drama,529651467
40000000,190212113,Steve Martin,Shawn Levy,98,Comedy,150212113
40000000,51070807,Jason Statham,Simon West,93,Action,11070807
40000000,60474340,Kirsten Dunst,Sofia Coppola,123,Drama,20474340
40000000,55247881,Thomas Horn,Stephen Daldry,129,Drama,15247881
40000000,16872671,Angelina Jolie,Stephen Herek,103,Comedy,-23127329
40000000,62771059,Hilary Swank,Stephen Hopkins,99,Horror,22771059
40000000,162610473,Tom Hanks,Steven Spielberg,141,Thriller,122610473
40000000,124731534,Jamie Foxx,Taylor Hackford,152,Drama,84731534
40000000,117195061,Johnny Depp,Tim Burton,77,Romance,77195061
40000000,46471023,George Clooney,Wes Anderson,87,Adventure,6471023
40000000,161834276,David Arquette,Wes Craven,116,Horror,121834276
40000000,97138686,David Arquette,Wes Craven,111,Horror,57138686
40000000,18902015,Stephen Dorff,William Malone,101,Horror,-21097985
40000000,176997168,Clint Eastwood,Wolfgang Petersen,128,Action,136997168
40600000,90400000,Eddie Murphy,John Landis,116,Comedy,49800000
41000000,215000000,Eminem,Curtis Hanson,110,Drama,174000000
41000000,7448385,Owen Wilson,David Frankel,100,Comedy,-33551615
41000000,91636986,Paul Rudd,John Hamburg,105,Comedy,50636986
41300000,106371651,Bruce Willis,Jonathan Lynn,98,Comedy,65071651
42000000,24127895,Nicolas Cage,Andrew Niccol,122,Crime,-17872105
42000000,20844907,Bob Hoskins,Annabel Jankel,104,Adventure,-21155093
42000000,46221189,Sam Worthington,Asger Leth,102,Action,4221189
42000000,63781810,Ashley Judd,Carl Franklin,115,Drama,21781810
42000000,89162162,Amanda Seyfried,Catherine Hardwicke,100,Thriller,47162162
42000000,62000000,Billy Campbell,Joe Johnston,108,Action,20000000
42000000,32168970,Ben Affleck,John Frankenheimer,124,Thriller,-9831030
42000000,119946358,Sylvester Stallone,John G. Avildsen,104,Drama,77946358
42000000,171963386,Ben Stiller,John Hamburg,90,Comedy,129963386
42000000,117575636,Julianne Moore,Joseph Ruben,91,Crime,75575636
42000000,180274123,Naomi Watts,Juan Antonio Bayona,113,Drama,138274123
42000000,7959291,Ralph Fiennes,Kathryn Bigelow,145,Crime,-34040709
42000000,35402320,Angelina Jolie,Michael Cristofer,118,Drama,-6597680
42000000,201585328,Channing Tatum,Phil Lord,109,Action,159585328
42000000,363889678,Julia Roberts,Roger Michell,124,Comedy,321889678
42000000,106645357,Jason Bateman,Sean Anders,108,Comedy,64645357
42000000,270248367,Tom Cruise,Sydney Pollack,154,Drama,228248367
43000000,80049764,Sean Connery,Gus Van Sant,136,Drama,37049764
43000000,91974818,Kate Hudson,Iain Softley,104,Drama,48974818
43000000,158674180,Sandra Bullock,Paul Feig,117,Action,115674180
43000000,56681566,Jennifer Garner,Rob Bowman,97,Action,13681566
43000000,154749918,Jennifer Lopez,Robert Luketic,101,Comedy,111749918
43000000,68696770,Cameron Diaz,Roger Kumble,84,Romance,25696770
44000000,368875760,Harrison Ford,Andrew Davis,130,Adventure,324875760
44000000,63327201,Saoirse Ronan,Andrew Niccol,125,Action,19327201
44000000,165615285,Robert De Niro,Barry Levinson,147,Crime,121615285
44000000,48190704,Zac Efron,Burr Steers,99,Drama,4190704
44000000,11305175,James Franco,Evan Goldberg,112,Action,-32694825
44000000,300400432,Sylvester Stallone,George P. Cosmatos,96,Action,256400432
44000000,3484331,Kris Kristofferson,Michael Cimino,219,Action,-40515669
44000000,13681765,Anthony Hopkins,Oliver Stone,192,History,-30318235
44000000,155760117,Samuel L. Jackson,Quentin Tarantino,167,Crime,111760117
44500000,232324128,Ben Affleck,Ben Affleck,120,Drama,187824128
45000000,195268056,Julia Roberts,Alan J. Pakula,141,Action,150268056
45000000,129394835,Milla Jovovich,Alexander Witt,94,Horror,84394835
45000000,104876233,Denzel Washington,Antoine Fuqua,122,Action,59876233
45000000,24000000,Johnny Depp,Bruce Robinson,120,Drama,-21000000
45000000,124914842,Reese Witherspoon,Charles Herman-Wurmfeld,95,Comedy,79914842
45000000,65470529,Angelina Jolie,D.J. Caruso,103,Action,20470529
45000000,113916474,Piper Perabo,David McNally,100,Comedy,68916474
45000000,178262620,Anna Faris,David Zucker,83,Comedy,133262620
45000000,90683916,Tim Allen,Dean Parisot,102,Comedy,45683916
45000000,212000000,Sandra Bullock,Donald Petrie,111,Comedy,167000000
45000000,101702060,Brendan Fraser,Eric Brevig,93,Action,56702060
45000000,58620973,Robin Williams,Francis Ford Coppola,113,Comedy,13620973
45000000,165184237,Amy Adams,James Bobin,103,Comedy,120184237
45000000,103071443,Alexander Nathan Etel,Jay Russell,112,Fantasy,58071443
45000000,56070433,Will Ferrell,Jesse Dylan,95,Romance,11070433
45000000,117615211,Susan Sarandon,Joel Schumacher,119,Drama,72615211
45000000,21009180,Dennis Quaid,John Moore,113,Action,-23990820
45000000,57881056,Carter Jenkins,John Schultz,86,Adventure,12881056
45000000,92374674,Mark Wahlberg,John Singleton,109,Action,47374674
45000000,141220678,Anna Faris,Keenen Ivory Wayans,83,Comedy,96220678
45000000,112006296,Robert De Niro,Kenneth Branagh,123,Drama,67006296
45000000,50871113,Jet Li,Louis Leterrier,103,Action,5871113
45000000,136885767,Jennifer Lopez,Luis Llosa,89,Adventure,91885767
45000000,170362582,Sylvester Stallone,Luis Llosa,110,Action,125362582
45000000,30822861,Karl Urban,Marcus Nispel,99,Action,-14177139
45000000,21355893,Richard Gere,Mark Rydell,98,Drama,-23644107
45000000,10667893,Jean-Claude Van Damme,Mic Rodgers,82,Action,-34332107
45000000,7810000,James Purefoy,Michael J. Bassett,104,Adventure,-37190000
45000000,14793624,Ben Affleck,Mike Mitchell,91,Comedy,-30206376
45000000,4607608,Javier Bardem,Mike Newell,139,Drama,-40392392
45000000,160078586,Rowan Atkinson,Oliver Parker,101,Crime,115078586
45000000,47000000,Blake Lively,Oliver Stone,131,Crime,2000000
45000000,376141306,Liam Neeson,Olivier Megaton,91,Action,331141306
45000000,42487390,Nicolas Cage,Oxide Pang Chun,99,Action,-2512610
45000000,20350754,Elizabeth Berkley,Paul Verhoeven,128,Drama,-24649246
45000000,73762516,Jason Statham,Paul W.S. Anderson,105,Action,28762516
45000000,224834564,Mel Gibson,Peter Lord,84,Animation,179834564
45000000,178051587,Harrison Ford,Phillip Noyce,117,Drama,133051587
45000000,72028752,Dennis Quaid,Raja Gosnell,90,Comedy,27028752
45000000,82800000,Harrison Ford,Richard Loncraine,105,Thriller,37800000
45000000,30353232,Tyler Perry,Rob Cohen,101,Action,-14646768
45000000,306776732,Catherine Zeta-Jones,Rob Marshall,113,Action,261776732
45000000,175372502,Jack Nicholson,Rob Reiner,97,Comedy,130372502
45000000,788241776,Jonathan Taylor Thomas,Roger Allers,89,Family,743241776
45000000,94935764,Ben Affleck,Roger Michell,89,Action,49935764
45000000,60222298,Ewan McGregor,Roman Polanski,128,Thriller,15222298
45000000,53854588,Kevin Costner,Ron Shelton,135,Comedy,8854588
45000000,147717833,Milla Jovovich,Russell Mulcahy,94,Horror,102717833
45000000,17300889,Billy Zane,Simon Wincer,100,Adventure,-27699111
45000000,184376254,Denzel Washington,Spike Lee,129,Crime,139376254
45000000,9323833,Derek Luke,Spike Lee,160,Thriller,-35676167
45000000,131183530,Wesley Snipes,Stephen Norrington,120,Horror,86183530
45000000,11203026,Treat Williams,Stephen Sommers,106,Adventure,-33796974
45000000,16809014,Martin Lawrence,Steve Carr,103,Comedy,-28190986
45000000,38058335,Matthew Broderick,Susan Stroman,134,Comedy,-6941665
45000000,181000000,Jim Carrey,Tom Shadyac,86,Comedy,136000000
45000000,86165646,Ryan Guzman,Trish Sie,112,Romance,41165646
45000000,38399961,Queen Latifah,Wayne Wang,112,Adventure,-6600039
46000000,341631208,John Goodman,Brian Levant,91,Fantasy,295631208
46000000,113714830,Al Pacino,Christopher Nolan,118,Crime,67714830
46000000,122126687,Hugh Jackman,Denis Villeneuve,153,Drama,76126687
46000000,100860818,Denzel Washington,Edward Zwick,117,Drama,54860818
46000000,107196498,Samuel L. Jackson,John Singleton,99,Action,61196498
46000000,150000000,James Cromwell,Jonathan Frakes,111,Science Fiction,104000000
47000000,102825796,Jim Carrey,Ben Stiller,96,Comedy,55825796
47000000,15691192,Tom Hanks,Brian De Palma,125,Comedy,-31308808
47000000,3547209,Jared Leto,Jaco Van Dormael,141,Science Fiction,-43452791
47000000,10539000,Josh Brolin,Jimmy Hayward,80,Action,-36461000
47000000,7191399,G√©rard Depardieu,Ridley Scott,154,Action,-39808601
47000000,12379402,Julia Roberts,Stephen Frears,104,Drama,-34620598
47000000,157887643,Emma Bell,Steven Quale,92,Horror,110887643
47000000,30002758,George Clooney,Steven Soderbergh,99,Drama,-16997242
47000000,103738726,Warren Beatty,Warren Beatty,103,Adventure,56738726
48000000,196397415,Jodie Foster,David Fincher,112,Crime,148397415
48000000,220673217,Pamela Anderson,David Zucker,84,Comedy,172673217
48000000,249348933,Naomi Watts,Gore Verbinski,115,Horror,201348933
48000000,90383208,Elizabeth Hurley,Harold Ramis,93,Fantasy,42383208
48000000,50315140,Jeff Bridges,Iain Softley,120,Drama,2315140
48000000,85498534,Cuba Gooding Jr.,Jerry Zucker,112,Adventure,37498534
48000000,124305181,Pierce Brosnan,John McTiernan,113,Drama,76305181
48000000,390493908,Kevin Costner,Kevin Reynolds,143,Adventure,342493908
48000000,112462508,Dwayne Johnson,Michael Lembeck,101,Comedy,64462508
48000000,325771424,Liam Neeson,Olivier Megaton,109,Crime,277771424
48000000,35743308,Drew Barrymore,Penny Marshall,132,Comedy,-12256692
48000000,77745568,George Clooney,Steven Soderbergh,123,Romance,29745568
48000000,207515725,Michael Douglas,Steven Soderbergh,148,Drama,159515725
48000000,474171806,Harrison Ford,Steven Spielberg,127,Adventure,426171806
49000000,102069268,Sharlto Copley,Neill Blomkamp,120,Crime,53069268
49000000,352927224,Michael Douglas,Paul Verhoeven,127,Thriller,303927224
49000000,20423389,Andrew Dice Clay,Renny Harlin,104,Action,-28576611
49900000,26121638,Danny McBride,David Gordon Green,102,Adventure,-23778362
50000000,173649015,Will Ferrell,Adam McKay,119,Comedy,123649015
50000000,90450008,John Travolta,Adam Shankman,117,Comedy,40450008
50000000,119137784,Richard Gere,Adrian Lyne,124,Drama,69137784
50000000,38955598,Kevin Spacey,Alan Parker,130,Drama,-11044402
50000000,155446362,Nicolas Cage,Alex Proyas,121,Action,105446362
50000000,113309743,Demi Moore,Andrew Bergman,115,Drama,63309743
50000000,60209334,Keanu Reeves,Andrew Davis,107,Adventure,10209334
50000000,11534477,William Baldwin,Andrew Sipes,91,Action,-38465523
50000000,12764201,Kristin Kreuk,Andrzej Bartkowiak,97,Action,-37235799
50000000,79958599,Steven Seagal,Andrzej Bartkowiak,101,Action,29958599
50000000,106303988,Dwayne Johnson,Andy Fickman,98,Adventure,56303988
50000000,66002004,Lindsay Lohan,Angela Robinson,101,Comedy,16002004
50000000,56714147,Sandra Bullock,Barbet Schroeder,120,Crime,6714147
50000000,87528173,Robin Williams,Barry Sonnenfeld,99,Comedy,37528173
50000000,40203020,Ren√©e Zellweger,Beeban Kidron,108,Comedy,-9796980
50000000,110206216,Brad Pitt,Bennett Miller,133,Drama,60206216
50000000,287928194,Christina Ricci,Brad Silberling,100,Fantasy,237928194
50000000,49111202,Josh Hartnett,Brian De Palma,121,Drama,-888798
50000000,61112916,Tim Allen,Brian Robbins,98,Comedy,11112916
50000000,120081841,Matt Damon,Cameron Crowe,124,Drama,70081841
50000000,273552592,Tom Cruise,Cameron Crowe,139,Comedy,223552592
50000000,55495563,Denzel Washington,Carl Franklin,105,Thriller,5495563
50000000,709827462,Kristen Stewart,Chris Weitz,130,Adventure,659827462
50000000,97607453,Radha Mitchell,Christophe Gans,125,Horror,47607453
50000000,50068310,Clint Eastwood,Clint Eastwood,121,Crime,68310
50000000,26199517,Clint Eastwood,Clint Eastwood,110,Crime,-23800483
50000000,105197635,Matt Damon,Clint Eastwood,129,Drama,55197635
50000000,10541523,John Travolta,Costa-Gavras,114,Action,-39458477
50000000,144492830,Alex Pettyfer,D.J. Caruso,109,Action,94492830
50000000,3324330,Tom Hardy,Daniel Espinosa,137,Crime,-46675670
50000000,32017803,Cillian Murphy,Danny Boyle,107,Science Fiction,-17982197
50000000,88323487,Jackie Chan,David Dobkin,115,Action,38323487
50000000,83719388,Robert Downey Jr.,David Dobkin,141,Drama,33719388
50000000,109423648,Michael Douglas,David Fincher,129,Drama,59423648
50000000,159773545,Sigourney Weaver,David Fincher,114,Science Fiction,109773545
50000000,16478900,Charlie Sheen,Deran Sarafian,102,Action,-33521100
50000000,177371441,Kate Hudson,Donald Petrie,116,Comedy,127371441
50000000,44547681,Samuel L. Jackson,F. Gary Gray,140,Action,-5452319
50000000,152000000,Laura Linney,Frank Marshall,109,Action,102000000
50000000,49718611,Kate Hudson,Garry Marshall,119,Drama,-281389
50000000,104478416,Martin Freeman,Garth Jennings,109,Adventure,54478416
50000000,100020092,Michael Douglas,Gary Fleder,113,Thriller,50020092
50000000,6808550,Owen Wilson,George Armitage,88,Comedy,-43191450
50000000,142851197,Steve Carell,Glenn Ficarra,118,Comedy,92851197
50000000,7033683,Jim Caviezel,Howard McCain,115,Fantasy,-42966317
50000000,260095987,Joel Courtney,J.J. Abrams,112,Thriller,210095987
50000000,80383113,Ricky Gervais,James Bobin,112,Comedy,30383113
50000000,22540359,Chris O'Donnell,James Foley,113,Drama,-27459641
50000000,314178011,Jack Nicholson,James L. Brooks,139,Comedy,264178011
50000000,222809600,Liam Neeson,Jaume Collet-Serra,106,Action,172809600
50000000,71561644,Liam Neeson,Jaume Collet-Serra,114,Action,21561644
50000000,110803676,Johnny Knoxville,Jay Chandrasekhar,104,Action,60803676
50000000,23717291,Dudley Moore,Jeannot Szwarc,108,Adventure,-26282709
50000000,38502340,Daniel Craig,Jim Sheridan,92,Drama,-11497660
50000000,41482207,Zach Galligan,Joe Dante,106,Comedy,-8517793
50000000,55181129,Julia Roberts,John A. Davis,88,Fantasy,5181129
50000000,42277365,Kurt Russell,John Carpenter,97,Action,-7722635
50000000,57059003,Aileen Quinn,John Huston,127,Comedy,7059003
50000000,119208989,Eddie Murphy,John Landis,104,Action,69208989
50000000,42792561,John Travolta,John McTiernan,98,Action,-7207439
50000000,44434439,Paul Walker,John Stockwell,110,Action,-5565561
50000000,150270147,John Travolta,John Woo,108,Action,100270147
50000000,234989584,Jason Biggs,Jon Hurwitz,113,Comedy,184989584
50000000,97437106,Diego Luna,Jorge R. Gutierrez,95,Romance,47437106
50000000,219788712,Dane Cook,Klay Hall,91,Animation,169788712
50000000,111340801,Kate Beckinsale,Len Wiseman,106,Fantasy,61340801
50000000,8342132,Ewan McGregor,Marc Forster,99,Mystery,-41657868
50000000,40828540,Gerard Butler,Mark Neveldine,95,Action,-9171460
50000000,69834815,Frank Welker,Matthew O'Callaghan,86,Adventure,19834815
50000000,122915111,Sylvester Stallone,Mikael H√•fstr√∂m,115,Action,72915111
50000000,9448082,Javier Bardem,Milo≈° Forman,114,Drama,-40551918
50000000,73956241,Denzel Washington,Norman Jewison,146,Drama,23956241
50000000,28931401,Nicolas Cage,Patrick Lussier,105,Fantasy,-21068599
50000000,16671505,Joe Mantegna,Patrick Read Johnson,99,Action,-33328495
50000000,41037742,Karl Urban,Pete Travis,95,Action,-8962258
50000000,170128460,Richard Gere,Peter Chelsom,107,Drama,120128460
50000000,200804534,Bill Murray,Peter Hewitt,80,Animation,150804534
50000000,82169884,Gaspard Ulliel,Peter Webber,121,Crime,32169884
50000000,188441614,Jonah Hill,Phil Lord,112,Crime,138441614
50000000,25195000,Ashley Judd,Philip Kaufman,97,Action,-24805000
50000000,36348784,Tom Sturridge,Richard Curtis,116,Drama,-13651216
50000000,30303072,Sylvester Stallone,Richard Donner,132,Action,-19696928
50000000,48169156,Demi Moore,Ridley Scott,125,Action,-1830844
50000000,212902372,Meryl Streep,Rob Marshall,125,Fantasy,162902372
50000000,58900031,Bruce Willis,Rob Reiner,95,Comedy,8900031
50000000,69425966,Taylor Lautner,Robert Rodriguez,92,Adventure,19425966
50000000,151165787,Dane Cook,Roberts Gannaway,83,Animation,101165787
50000000,10382407,Demi Moore,Roland Joff√©,135,Drama,-39617593
50000000,42093706,Barney Clark,Roman Polanski,130,Crime,-7906294
50000000,13260050,Claire Danes,Scott Silver,92,Action,-36739950
50000000,240360392,Will Ferrell,Sean Anders,96,Comedy,190360392
50000000,549368315,Mark Wahlberg,Seth MacFarlane,106,Comedy,499368315
50000000,94000000,George Clooney,Stephen Gaghan,128,Drama,44000000
50000000,75000000,Michael Douglas,Stephen Hopkins,109,Adventure,25000000
50000000,171269535,Adam Sandler,Steven Brill,96,Comedy,121269535
50000000,160602194,Richard Armitage,Steven Quale,89,Action,110602194
50000000,49000000,Steven Seagal,Steven Seagal,102,Action,-1000000
50000000,113244290,Sylvester Stallone,Sylvester Stallone,92,Action,63244290
50000000,152000000,Johnny Depp,Tim Burton,116,Drama,102000000
50000000,88715192,Matthew McConaughey,Tom Dey,97,Comedy,38715192
50000000,83761844,Owen Wilson,Tom Dey,87,Family,33761844
50000000,202292902,Robin Williams,Tom Shadyac,115,Comedy,152292902
50000000,132180323,Ben Whishaw,Tom Tykwer,147,Crime,82180323
50000000,60161391,Clive Owen,Tom Tykwer,118,Drama,10161391
50000000,224803475,Jeremy Renner,Tommy Wirkola,88,Fantasy,174803475
50000000,22944502,Keira Knightley,Tony Scott,127,Action,-27055498
50000000,34808403,Bill Murray,Wes Anderson,119,Adventure,-15191597
50000000,9851610,David Caruso,William Friedkin,95,Action,-40148390
50100000,153962963,Will Smith,Glenn Ficarra,105,Romance,103862963
50200000,127869379,Matt Damon,George Nolfi,106,Thriller,77669379
51000000,36911617,Chris O'Donnell,Gary Sinyor,101,Comedy,-14088383
51000000,149270999,Jim Carrey,Peter Farrelly,116,Comedy,98270999
51000000,72779000,Courteney Cox,Steve Oedekerk,90,Animation,21779000
51500000,55112356,Naomi Watts,David Cronenberg,100,Thriller,3612356
52000000,75450437,Olivia Wilde,David Dobkin,112,Comedy,23450437
52000000,77944725,Bruce Willis,Florent-Emilio Siri,113,Mystery,25944725
52000000,216485654,Jessica Alba,Garry Marshall,125,Comedy,164485654
52000000,116112375,Robert De Niro,Martin Scorsese,178,Drama,64112375
52000000,204999686,Vince Vaughn,Peyton Reed,106,Romance,152999686
52000000,609841637,Meryl Streep,Phyllida Lloyd,108,Comedy,557841637
52000000,52615806,John Travolta,Pierre Morel,92,Action,615806
52000000,355237933,Tom Hanks,Ron Howard,140,Drama,303237933
52000000,256271286,Julia Roberts,Steven Soderbergh,131,Drama,204271286
52000000,352114312,Leonardo DiCaprio,Steven Spielberg,141,Drama,300114312
52000000,98126565,Sean Penn,Terrence Malick,170,Drama,46126565
52500000,179213434,Nicole Kidman,Baz Luhrmann,127,Romance,126713434
53000000,139804348,Meg Ryan,Don Bluth,94,Animation,86804348
53000000,126690726,Jamie Foxx,F. Gary Gray,109,Drama,73690726
53000000,95226116,John Travolta,F. Gary Gray,118,Comedy,42226116
53000000,29700000,Jennifer Lopez,Luis Mandoki,102,Drama,-23300000
53000000,99775678,Johnny Depp,Scott Cooper,122,Crime,46775678
53000000,83282296,Johnny Depp,Ted Demme,124,Crime,30282296
53000000,157387195,Denzel Washington,Tony Scott,116,Action,104387195
54000000,130431368,Kate Hudson,Anthony Russo,108,Comedy,76431368
54000000,136766062,Al Pacino,Francis Ford Coppola,162,Drama,82766062
54000000,155010032,Wesley Snipes,Guillermo del Toro,117,Science Fiction,101010032
54000000,132511035,Natalie Portman,James McTeigue,132,Action,78511035
54000000,7266209,Ben Affleck,Martin Brest,121,Drama,-46733791
54000000,108185706,Gene Hackman,Richard Lester,127,Action,54185706
54000000,320689294,Glenn Close,Stephen Herek,103,Comedy,266689294
54000000,128769345,Eddie Murphy,Tom Shadyac,95,Fantasy,74769345
55000000,141047179,Madonna,Alan Parker,134,History,86047179
55000000,63408614,Sylvester Stallone,Andrei Konchalovsky,104,Action,8408614
55000000,192330738,Denzel Washington,Antoine Fuqua,132,Thriller,137330738
55000000,203427584,Jason Clarke,Baltasar Korm√°kur,121,Adventure,148427584
55000000,214015089,Michael Douglas,Barry Levinson,123,Drama,159015089
55000000,33828318,Matt Damon,Bobby Farrelly,118,Comedy,-21171682
55000000,198685114,Nicolas Cage,Brad Silberling,114,Drama,143685114
55000000,113020255,Angelina Jolie,Clint Eastwood,141,Crime,58020255
55000000,307077295,Will Smith,Gabriele Muccino,117,Drama,252077295
55000000,168167691,Will Smith,Gabriele Muccino,123,Drama,113167691
55000000,17869048,Saoirse Ronan,Gil Kenan,90,Adventure,-37130952
55000000,74679822,Mia Wasikowska,Guillermo del Toro,119,Mystery,19679822
55000000,70016220,Russell Crowe,James Mangold,122,Western,15016220
55000000,330444045,Ben Stiller,Jay Roach,108,Comedy,275444045
55000000,127600435,Sean Connery,Jerry Zucker,134,Action,72600435
55000000,231449203,Jason Biggs,Jesse Dylan,103,Comedy,176449203
55000000,6416302,Sylvester Stallone,Jim Gillespie,96,Action,-48583698
55000000,110000000,Owen Wilson,Jimmy Hayward,91,Animation,55000000
55000000,41610884,Robert De Niro,John Frankenheimer,122,Action,-13389116
55000000,187361754,Jim Carrey,Mark Waters,94,Comedy,132361754
55000000,346079773,Irene Bedard,Mike Gabriel,81,Adventure,291079773
55000000,100230832,Al Pacino,Oliver Stone,150,Drama,45230832
55000000,95000000,Tom Hanks,Paul Greengrass,134,Action,40000000
55000000,259207227,Nicole Kidman,Paul King,95,Comedy,204207227
55000000,65664721,Bruce Willis,Richard Donner,105,Action,10664721
55000000,300218018,Marlon Brando,Richard Donner,143,Adventure,245218018
55000000,127906624,Jackie Chan,Rob Minkoff,104,Action,72906624
55000000,11466088,Ray Liotta,Robert Butler,100,Action,-43533912
55000000,223387299,Jodie Foster,Robert Schwentke,98,Thriller,168387299
55000000,677945399,Tom Hanks,Robert Zemeckis,142,Comedy,622945399
55000000,196567262,Kurt Russell,Roland Emmerich,121,Action,141567262
55000000,152263880,Steve Carell,Shawn Levy,97,Comedy,97263880
55000000,89519773,Cher,Steve Antin,119,Drama,34519773
55000000,9450897,Sean Penn,Steven Zaillian,125,Drama,-45549103
55000000,121969216,Kurt Russell,Stuart Baird,133,Action,66969216
55000000,31987563,Eddie Murphy,Thomas Carter,117,Action,-23012437
55000000,56932305,Jackie Chan,Tom Dey,110,Adventure,1932305
55000000,18626419,Robert De Niro,Tony Scott,116,Drama,-36373581
55000000,9489829,Sylvester Stallone,Walter Hill,92,Action,-45510171
55000000,154906693,Jennifer Lopez,Wayne Wang,105,Comedy,99906693
55000000,34234008,Tommy Lee Jones,William Friedkin,94,Drama,-20765992
56000000,113006880,Vin Diesel,Adam Shankman,95,Action,57006880
56000000,19701164,Mark Wahlberg,Allen Hughes,109,Thriller,-36298836
56000000,142044638,Robert De Niro,Garry Marshall,118,Comedy,86044638
56000000,57223890,Dwayne Johnson,Kevin Bray,86,Adventure,1223890
56000000,12923936,Stephen Lang,Ronald F. Maxwell,214,Drama,-43076064
57000000,52034889,Orlando Bloom,Cameron Crowe,123,Comedy,-4965111
57000000,147845033,Brad Pitt,Gore Verbinski,123,Action,90845033
57000000,62112895,Nicolas Cage,John Madden,131,Drama,5112895
57000000,28283637,Brady Corbet,Jonathan Frakes,95,Action,-28716363
57000000,159055768,Sylvester Stallone,Marco Brambilla,115,Action,102055768
57000000,149217355,Nicolas Cage,Mark Neveldine,95,Action,92217355
57000000,115267375,Dennis Quaid,Rob Cohen,103,Fantasy,58267375
57000000,16991902,Mark Wahlberg,Stephen Herek,105,Music,-40008098
57000000,152944660,Keanu Reeves,Taylor Hackford,144,Drama,95944660
58000000,50365377,Bryan Cranston,Anthony Hemingway,125,Drama,-7634623
58000000,25928721,Richard Gere,Francis Ford Coppola,127,Music,-32071279
58000000,85280250,Hugh Grant,Marc Lawrence,103,Comedy,27280250
58000000,102854431,Reese Witherspoon,Mark Waters,95,Comedy,44854431
58000000,352194034,Pierce Brosnan,Martin Campbell,130,Adventure,294194034
58000000,150170815,Jack Black,Rob Letterman,103,Adventure,92170815
58000000,71664962,Bruce Willis,Robert Schwentke,111,Action,13664962
58000000,44000000,Owen Wilson,Shawn Levy,119,Comedy,-14000000
58800000,542307423,Bradley Cooper,Clint Eastwood,134,War,483507423
59000000,383257136,Ray Romano,Chris Wedge,81,Animation,324257136
60000000,129181830,Steve Martin,Adam Shankman,94,Adventure,69181830
60000000,30800231,Colin Farrell,Akiva Goldsman,118,Drama,-29199769
60000000,484409218,Mike Myers,Andrew Adamson,90,Adventure,424409218
60000000,128038368,Michael Douglas,Andrew Davis,107,Crime,68038368
60000000,55987321,Dwayne Johnson,Andrzej Bartkowiak,100,Action,-4012679
60000000,127766650,Ben Stiller,Bobby Farrelly,116,Comedy,67766650
60000000,124745083,Nicolas Cage,Brett Ratner,125,Comedy,64745083
60000000,61347797,Pierce Brosnan,Brett Ratner,97,Action,1347797
60000000,129832389,Arnold Schwarzenegger,Brian Levant,89,Comedy,69832389
60000000,95673607,Eddie Murphy,Brian Robbins,101,Comedy,35673607
60000000,50650079,Eddie Murphy,Brian Robbins,90,Comedy,-9349921
60000000,47383689,Kate Hudson,Cameron Crowe,122,Drama,-12616311
60000000,13395939,Jude Law,Charles Shyer,103,Comedy,-46604061
60000000,218340595,Tom Cruise,Christopher McQuarrie,130,Crime,158340595
60000000,165333180,Dwayne Johnson,Chuck Russell,92,Action,105333180
60000000,77920346,Michael Douglas,Clark Johnson,108,Action,17920346
60000000,122233971,Morgan Freeman,Clint Eastwood,134,Drama,62233971
60000000,244082376,Owen Wilson,David Frankel,115,Comedy,184082376
60000000,30418560,Johnny Depp,David Koepp,106,Comedy,-29581440
60000000,101134059,Jennifer Lawrence,David O. Russell,124,Comedy,41134059
60000000,214034224,Matt Damon,Doug Liman,119,Action,154034224
60000000,47664559,Michael Cera,Edgar Wright,112,Action,-12335441
60000000,171757863,Woody Allen,Eric Darnell,83,Adventure,111757863
60000000,176070171,Mark Wahlberg,F. Gary Gray,111,Thriller,116070171
60000000,16000000,Steven Seagal,F√©lix Enr√≠quez Alcal√°,105,Action,-44000000
60000000,284600000,Tom Hanks,Frank Darabont,189,Fantasy,224600000
60000000,39031337,Gabriel Macht,Frank Miller,103,Action,-20968663
60000000,137587063,Josh Hutcherson,G√°bor Csup√≥,96,Adventure,77587063
60000000,80154140,John Cusack,Gary Fleder,127,Drama,20154140
60000000,104324083,Steven Seagal,Geoff Murphy,100,Action,44324083
60000000,108255770,Ben Kingsley,Graham Annable,97,Animation,48255770
60000000,37141130,Vince Vaughn,Gus Van Sant,105,Horror,-22858870
60000000,90565421,Lily Collins,Harald Zwart,130,Action,30565421
60000000,62357900,Jack Black,Harold Ramis,97,Comedy,2357900
60000000,124596398,Dakota Fanning,Henry Selick,100,Animation,64596398
60000000,57490374,Brendan Fraser,Iain Softley,106,Adventure,-2509626
60000000,37000000,Arnold Schwarzenegger,Ivan Reitman,109,Comedy,-23000000
60000000,74541707,Joaquin Phoenix,Jay Russell,115,Drama,14541707
60000000,48522832,Ralph Fiennes,Jeremiah S. Chechik,89,Thriller,-11477168
60000000,31720158,Robert Downey Jr.,Joe Wright,109,Drama,-28279842
60000000,119940815,George Clooney,Joel Coen,100,Crime,59940815
60000000,56359980,Robert De Niro,John Herzfeld,120,Action,-3640020
60000000,96269812,Ben Affleck,John Woo,119,Action,36269812
60000000,74208267,Aaron Eckhart,Jon Amiel,136,Action,14208267
60000000,73174566,Robert De Niro,Jon Avnet,101,Action,13174566
60000000,35431113,Wesley Snipes,Joseph Ruben,103,Action,-24568887
60000000,8106475,Kirsten Dunst,Juan Diego Solanas,104,Romance,-51893525
60000000,50549107,Chris Pine,Kenneth Branagh,105,Action,-9450893
60000000,87784194,Russell Crowe,Kevin Macdonald,127,Action,27784194
60000000,93375151,Jeff Goldblum,Lawrence Guterman,87,Comedy,33375151
60000000,105178561,Morgan Freeman,Lee Tamahori,104,Crime,45178561
60000000,66976317,Milla Jovovich,Luc Besson,148,Adventure,6976317
60000000,256697520,Bryce Dallas Howard,M. Night Shyamalan,108,Drama,196697520
60000000,163403799,Mark Wahlberg,M. Night Shyamalan,91,Thriller,103403799
60000000,93354918,Sandra Bullock,Marc Lawrence,101,Romance,33354918
60000000,159330280,Bruce Willis,Michael Caton-Jones,124,Action,99330280
60000000,187436818,Al Pacino,Michael Mann,171,Action,127436818
60000000,223664608,Brad Pitt,Neil Jordan,123,Horror,163664608
60000000,26673242,Laurence Fishburne,Paul W.S. Anderson,96,Horror,-33326758
60000000,296221663,Milla Jovovich,Paul W.S. Anderson,97,Action,236221663
60000000,33956608,Penelope Ann Miller,Peter Hyams,110,Horror,-26043392
60000000,118338361,Hugh Grant,Peter Lord,88,Animation,58338361
60000000,264118201,Jim Carrey,Peter Weir,103,Comedy,204118201
60000000,469160692,Will Arnett,Phil Lord,100,Adventure,409160692
60000000,73648228,Thomas Jane,Renny Harlin,105,Horror,13648228
60000000,60052138,Alden Ehrenreich,Richard LaGravenese,124,Fantasy,52138
60000000,43061982,Christian Bale,Rob Bowman,101,Action,-16938018
60000000,186883563,Robert Redford,Robert Redford,170,Drama,126883563
60000000,50877145,Matthew Broderick,Robert Stevenhagen,100,Animation,-9122855
60000000,313542341,Russell Crowe,Ron Howard,135,Drama,253542341
60000000,137783840,Tom Cruise,Ron Howard,140,Adventure,77783840
60000000,105200903,Sean Penn,Ruben Fleischer,113,Crime,45200903
60000000,204594016,Julia Roberts,Ryan Murphy,133,Drama,144594016
60000000,107139399,Kodi Smit-McPhee,Sam Fell,90,Family,47139399
60000000,78309131,Paul Bettany,Scott Stewart,87,Action,18309131
60000000,149705852,John Travolta,Simon West,116,Crime,89705852
60000000,164433867,Eddie Murphy,Steve Carr,92,Comedy,104433867
60000000,135458097,Matt Damon,Steven Soderbergh,106,Drama,75458097
60000000,219417255,Tom Hanks,Steven Spielberg,128,Comedy,159417255
60000000,67312826,Patrick Stewart,Stuart Baird,117,Science Fiction,7312826
60000000,102367405,Tommy Lee Jones,Stuart Baird,131,Thriller,42367405
60000000,361366633,Jason Lee,Tim Hill,92,Comedy,301366633
60000000,26288320,Brad Pitt,Tim Johnson,86,Family,-33711680
60000000,170268750,Ben Stiller,Todd Phillips,101,Comedy,110268750
60000000,52322400,Kevin Costner,Tom Shadyac,104,Drama,-7677600
60000000,17800000,James Franco,Tony Bill,140,Action,-42200000
60000000,157920733,Tom Cruise,Tony Scott,107,Adventure,97920733
60000000,71000000,Tommy Lee Jones,William Friedkin,128,Action,11000000
60795000,73090611,Halle Berry,James Foley,109,Crime,12295611
61000000,95696996,Mark Wahlberg,Antoine Fuqua,124,Action,34696996
61000000,131940411,Denzel Washington,Baltasar Korm√°kur,109,Action,70940411
61000000,369330363,Ben Affleck,David Fincher,145,Mystery,308330363
61000000,441809770,Hugh Jackman,Tom Hooper,157,Drama,380809770
61000000,311256926,Dylan O'Brien,Wes Ball,132,Action,250256926
62000000,1060056,Jeremy Irons,Adrian Lyne,137,Drama,-60939944
62000000,18720175,Kurt Russell,Demian Lichtenstein,125,Action,-43279825
62000000,127666415,Matthew McConaughey,Jonathan Mostow,116,Action,65666415
62000000,52304001,Charlize Theron,Karyn Kusama,93,Action,-9695999
62000000,41819064,Mike Myers,Marco Schnabel,87,Comedy,-20180936
62000000,215887717,Harrison Ford,Phillip Noyce,141,Action,153887717
62000000,107879496,Michael Douglas,Rob Reiner,106,Comedy,45879496
63000000,100853753,Edward Norton,David Fincher,139,Drama,37853753
63000000,296633907,Mike Myers,Jay Roach,94,Science Fiction,233633907
63000000,25052000,Kevin Costner,Lawrence Kasdan,191,Drama,-37948000
63000000,463517383,Keanu Reeves,Lilly Wachowski,136,Action,400517383
63000000,162945894,Nicolas Cage,Oliver Stone,128,Drama,99945894
63000000,189015611,Sylvester Stallone,Peter MacDonald,102,Action,126015611
63000000,920100000,Sam Neill,Steven Spielberg,127,Adventure,857100000
63000000,183953723,Russell Brand,Tim Hill,95,Animation,120953723
63600000,19412993,Sylvester Stallone,Stephen T. Kay,102,Action,-44187007
64000000,101595121,Marlon Wayans,Keenen Ivory Wayans,98,Comedy,37595121
64000000,97571250,Jeff Bridges,Mark Osborne,92,Adventure,33571250
64000000,74608570,Harrison Ford,Sydney Pollack,133,Drama,10608570
65000000,128107642,Will Ferrell,Adam McKay,98,Comedy,63107642
65000000,163442937,Jack O'Connell,Angelina Jolie,137,Drama,98442937
65000000,117487473,Heath Ledger,Brian Helgeland,132,Adventure,52487473
65000000,128884132,Clint Eastwood,Clint Eastwood,130,Action,63884132
65000000,44806783,Chris Hemsworth,Dan Bradley,93,War,-20193217
65000000,40002112,Jennifer Love Hewitt,Danny Cannon,100,Horror,-24997888
65000000,44091067,Nicolas Cage,David Bowers,94,Animation,-20908933
65000000,84785914,Jake Gyllenhaal,David Fincher,157,Crime,19785914
65000000,128905366,Wesley Snipes,David S. Goyer,123,Science Fiction,63905366
65000000,36850101,Jeff Daniels,Donald Petrie,94,Comedy,-28149899
65000000,39407616,Mickey Rourke,Frank Miller,102,Crime,-25592384
65000000,262797249,Robin Williams,Joe Johnston,104,Adventure,197797249
65000000,64321501,Jonah Bobo,Jon Favreau,101,Family,-678499
65000000,69700000,Bruce Willis,Jon Turteltaub,104,Fantasy,4700000
65000000,179379533,Sacha Baron Cohen,Larry Charles,83,Comedy,114379533
65000000,73706,Charlie Sheen,Lawrence Kasanoff,87,Animation,-64926294
65000000,117758500,Martin Lawrence,Les Mayfield,93,Thriller,52758500
65000000,43545364,Matthew McConaughey,McG,124,Drama,-21454636
65000000,17218080,Bruce Willis,Michael Lehmann,100,Action,-47781920
65000000,172855065,Tim Allen,Michael Lembeck,104,Fantasy,107855065
65000000,217764291,Tom Cruise,Michael Mann,120,Drama,152764291
65000000,415252786,Sarah Jessica Parker,Michael Patrick King,145,Comedy,350252786
65000000,250821495,Tom Hanks,Nora Ephron,119,Comedy,185821495
65000000,235666219,Melissa McCarthy,Paul Feig,120,Action,170666219
65000000,261317921,Arnold Schwarzenegger,Paul Verhoeven,113,Action,196317921
65000000,240159255,Milla Jovovich,Paul W.S. Anderson,95,Action,175159255
65000000,93525586,Rachel Weisz,Peter Jackson,136,Fantasy,28525586
65000000,89456761,Geena Davis,Renny Harlin,120,Action,24456761
65000000,162091208,Tom Cruise,Stanley Kubrick,159,Drama,97091208
65000000,275293450,Daniel Day-Lewis,Steven Spielberg,149,Drama,210293450
65000000,71154592,Aaron Eckhart,Stuart Beattie,92,Horror,6154592
65000000,211780824,Zach Galifianakis,Todd Phillips,95,Comedy,146780824
65000000,133821816,Quvenzhan√© Wallis,Will Gluck,119,Music,68821816
65000000,422610419,Gerard Butler,Zack Snyder,117,Action,357610419
66000000,57777106,Jason Statham,Gary McKendry,116,Action,-8222894
66000000,99318987,Ron Perlman,Guillermo del Toro,122,Fantasy,33318987
66000000,212404396,Sean Connery,Jon Amiel,112,Romance,146404396
66000000,189198313,David Duchovny,Rob Bowman,121,Mystery,123198313
66000000,203277636,Aaron Paul,Scott Waugh,130,Action,137277636
66000000,177584879,Tom Hiddleston,Steven Spielberg,146,Drama,111584879
67000000,25303038,Colin Firth,Doug Lefler,102,Action,-41696962
67000000,47267001,Bruce Willis,Walter Hill,101,Action,-19732999
68000000,68267862,Ben Stiller,Akiva Schaffer,98,Comedy,267862
68000000,203388341,Tom Cruise,Cameron Crowe,136,Drama,135388341
68000000,211817906,Brad Pitt,David Ayer,135,War,143817906
68000000,698491347,Kristen Stewart,David Slade,124,Adventure,630491347
68000000,71069884,Robert De Niro,Frank Oz,124,Action,3069884
68000000,29762011,Hank Azaria,Kinka Usher,121,Adventure,-38237989
68000000,75715436,Morgan Freeman,Lawrence Kasdan,136,Drama,7715436
68000000,118063304,Val Kilmer,Phillip Noyce,116,Thriller,50063304
68000000,215863606,Mark Wahlberg,Seth MacFarlane,115,Comedy,147863606
69000000,86387857,Steve Carell,Jay Roach,114,Comedy,17387857
69000000,543513985,Steve Carell,Pierre Coffin,95,Action,474513985
69000000,112265139,Benjamin Walker,Timur Bekmambetov,94,Action,43265139
70000000,39041505,Rachel Weisz,Alejandro Amen√°bar,127,Adventure,-30958495
70000000,55011732,Kevin Costner,Andrew Davis,139,Action,-14988268
70000000,111231041,Matthew McConaughey,Andy Tennant,112,Comedy,41231041
70000000,368100420,Will Smith,Andy Tennant,118,Comedy,298100420
70000000,85632458,Bruce Willis,Antoine Fuqua,121,Action,15632458
70000000,161025640,Gerard Butler,Antoine Fuqua,120,Action,91025640
70000000,33561137,Eddie Murphy,Betty Thomas,97,Action,-36438863
70000000,154937680,Jamie Foxx,Bill Condon,134,Drama,84937680
70000000,23159305,Jennifer Aniston,Brad Bird,86,Adventure,-46840695
70000000,218613188,Val Kilmer,Brenda Chapman,99,Adventure,148613188
70000000,177841558,Tommy Lee Jones,Bruce Beresford,105,Drama,107841558
70000000,348840316,Zac Efron,Chris Renaud,86,Animation,278840316
70000000,18662027,Lea Michele,Dan St. Pierre,88,Animation,-51337973
70000000,116672912,Denzel Washington,Edward Zwick,116,Drama,46672912
70000000,309457509,Julia Roberts,Garry Marshall,116,Comedy,239457509
70000000,215529201,Luke Evans,Gary Shore,92,Horror,145529201
70000000,154984035,Matt Damon,George Clooney,118,War,84984035
70000000,32287044,Bruce Willis,Gregory Hoblit,125,Drama,-37712956
70000000,11263966,Cuba Gooding Jr.,Hugh Johnson,101,Action,-58736034
70000000,164000000,Harrison Ford,Ivan Reitman,98,Action,94000000
70000000,90000098,Ed Harris,James Cameron,139,Adventure,20000098
70000000,131457682,Brad Pitt,Jean-Jacques Annaud,136,History,61457682
70000000,96976270,Jude Law,Jean-Jacques Annaud,131,War,26976270
70000000,162000000,Sigourney Weaver,Jean-Pierre Jeunet,109,Science Fiction,92000000
70000000,65977295,Anthony Hopkins,Joel Schumacher,116,Action,-4022705
70000000,154648887,Gerard Butler,Joel Schumacher,143,Thriller,84648887
70000000,118000000,Patrick Stewart,Jonathan Frakes,103,Science Fiction,48000000
70000000,202466756,Aaron Eckhart,Jonathan Liebesman,116,Action,132466756
70000000,104945765,Dwayne Johnson,Jorge Blanco,91,Science Fiction,34945765
70000000,57958696,Jude Law,Kerry Conran,107,Mystery,-12041304
70000000,18211013,Nicolas Cage,Lee Tamahori,96,Action,-51788987
70000000,132400000,Kate Beckinsale,M√•ns M√•rlind,88,Fantasy,62400000
70000000,72108608,Vin Diesel,Mathieu Kassovitz,101,Action,2108608
70000000,135560026,Claire Danes,Matthew Vaughn,127,Adventure,65560026
70000000,38629478,Sharon Stone,Michael Caton-Jones,114,Crime,-31370522
70000000,17752940,Chris Hemsworth,Michael Mann,133,Mystery,-52247060
70000000,19870567,Morgan Freeman,Mikael Salomon,97,Thriller,-50129433
70000000,374111707,Helen Hunt,Nancy Meyers,127,Comedy,304111707
70000000,69766619,Jodie Foster,Neil Jordan,122,Crime,-233381
70000000,134748021,Michael Douglas,Oliver Stone,133,Drama,64748021
70000000,442824138,Matt Damon,Paul Greengrass,115,Action,372824138
70000000,171183863,Sanaa Lathan,Paul W.S. Anderson,101,Adventure,101183863
70000000,86658558,Jamie Foxx,Peter Berg,110,Thriller,16658558
70000000,171844840,Vince Vaughn,Peter Billingsley,113,Comedy,101844840
70000000,225990978,Jim Carrey,Peyton Reed,104,Comedy,155990978
70000000,319131050,Brad Pitt,Quentin Tarantino,153,Drama,249131050
70000000,240031094,Bruce Willis,Renny Harlin,124,Action,170031094
70000000,61279452,Kellan Lutz,Renny Harlin,99,Action,-8720548
70000000,255000211,Sylvester Stallone,Renny Harlin,112,Action,185000211
70000000,113280098,Leonardo DiCaprio,Ridley Scott,128,Action,43280098
70000000,277448382,Vin Diesel,Rob Cohen,124,Action,207448382
70000000,88933562,Jennifer Aniston,Rob Reiner,97,Comedy,18933562
70000000,329803958,Bob Hoskins,Robert Zemeckis,104,Fantasy,259803958
70000000,195735876,Ray Winstone,Robert Zemeckis,115,Animation,125735876
70000000,67112664,Kevin James,Ron Howard,111,Comedy,-2887336
70000000,58058367,Adam Sandler,Sean Anders,116,Comedy,-11941633
70000000,176104344,Eddie Murphy,Steve Carr,87,Comedy,106104344
70000000,130358911,Eric Bana,Steven Spielberg,164,Drama,60358911
70000000,300854823,Robin Williams,Steven Spielberg,144,Adventure,230854823
70000000,481840909,Tom Hanks,Steven Spielberg,169,Drama,411840909
70000000,56702901,John Travolta,Steven Zaillian,115,Drama,-13297099
70000000,122919055,Ewan McGregor,Tim Burton,125,Adventure,52919055
70000000,101371017,Jack Nicholson,Tim Burton,106,Comedy,31371017
70000000,130293714,Denzel Washington,Tony Scott,146,Action,60293714
70000000,19924033,Antonio Banderas,Wych Kaosayananda,91,Action,-50075967
71000000,294456605,Eddie Murphy,Betty Thomas,85,Comedy,223456605
72000000,37317558,Jim Carrey,Frank Darabont,152,Drama,-34682442
72000000,408247917,Mel Gibson,M. Night Shyamalan,106,Drama,336247917
72000000,210000000,Mel Gibson,Mel Gibson,177,Action,138000000
72000000,27642707,Robert Redford,Rod Lurie,131,Action,-44357293
72000000,96889998,Jamie Foxx,Sam Mendes,125,Drama,24889998
72500000,162966177,Will Ferrell,Adam McKay,116,Comedy,90466177
73000000,103891409,Nicolas Cage,Brian De Palma,98,Crime,30891409
73000000,151493655,Denzel Washington,Phillip Noyce,118,Drama,78493655
73000000,229074524,Jeff Goldblum,Steven Spielberg,129,Adventure,156074524
74000000,1156730962,Sandra Bullock,Kyle Balda,91,Family,1082730962
74000000,311594032,Tom Kenny,Paul Tibbitt,93,Family,237594032
74500000,62172050,Ma√Ø Anh Le,Jean-Jacques Annaud,109,Adventure,-12327950
75000000,59418613,Tom Cruise,Adam Shankman,123,Comedy,-15581387
75000000,67631903,Bruce Willis,Barry Levinson,123,Action,-7368097
75000000,13100000,Dustin Hoffman,Barry Levinson,134,Science Fiction,-61900000
75000000,443140005,Zachary Levi,Betty Thomas,88,Comedy,368140005
75000000,367275019,Will Smith,Bibo Bergeron,90,Animation,292275019
75000000,13596911,Chris Rock,Bobby Farrelly,95,Adventure,-61403089
75000000,152930623,Ben Stiller,Brett Ratner,104,Action,77930623
75000000,93888180,Sandra Bullock,Bronwen Hughes,105,Comedy,18888180
75000000,157299717,Patrick Stewart,Bryan Singer,104,Adventure,82299717
75000000,200276000,Tom Cruise,Bryan Singer,121,Drama,125276000
75000000,260696994,Robin Williams,Chris Wedge,91,Animation,185696994
75000000,108000000,George Clooney,David O. Russell,114,Action,33000000
75000000,527068851,Dan Castellaneta,David Silverman,87,Animation,452068851
75000000,36754634,Matt Damon,Don Bluth,94,Animation,-38245366
75000000,532680671,Ben Stiller,Eric Darnell,86,Family,457680671
75000000,691210692,Jennifer Lawrence,Gary Ross,142,Science Fiction,616210692
75000000,140175006,Ryan Newman,Gil Kenan,91,Animation,65175006
75000000,46683377,Sandra Bullock,Griffin Dunne,104,Drama,-28316623
75000000,108145109,Henry Cavill,Guy Ritchie,116,Comedy,33145109
75000000,54249294,John Travolta,Harold Becker,89,Mystery,-20750706
75000000,5409517,Brendan Fraser,Henry Selick,93,Adventure,-69590483
75000000,14010690,Jamie Lee Curtis,John Bruno,99,Horror,-60989310
75000000,61458982,Adam Sandler,Judd Apatow,146,Comedy,-13541018
75000000,117698894,Jesse Eisenberg,Louis Leterrier,115,Thriller,42698894
75000000,248118121,Bruce Willis,M. Night Shyamalan,106,Action,173118121
75000000,42285169,Paul Giamatti,M. Night Shyamalan,110,Drama,-32714831
75000000,142400065,Antonio Banderas,Martin Campbell,129,Action,67400065
75000000,215663859,Chris O'Donnell,Martin Campbell,124,Action,140663859
75000000,335062621,Sean Connery,Michael Bay,136,Action,260062621
75000000,342695435,Jason Lee,Mike Mitchell,87,Comedy,267695435
75000000,119000410,Tom Hanks,Mike Nichols,102,Comedy,44000410
75000000,140464664,Robert Duvall,Mimi Leder,120,Action,65464664
75000000,288500217,Matt Damon,Paul Greengrass,108,Action,213500217
75000000,14567883,Kurt Russell,Paul W.S. Anderson,99,Action,-60432117
75000000,132274484,Milla Jovovich,Paul W.S. Anderson,110,Adventure,57274484
75000000,196482882,Adam Sandler,Peter Segal,99,Comedy,121482882
75000000,195745823,Adam Sandler,Peter Segal,106,Comedy,120745823
75000000,19598588,Johnny Depp,Rand Ravich,109,Drama,-55401412
75000000,114660784,Mel Gibson,Randall Wallace,138,Action,39660784
75000000,136982834,Mel Gibson,Richard Donner,135,Action,61982834
75000000,98159963,Katherine Heigl,Robert Luketic,100,Action,23159963
75000000,816969268,Will Smith,Roland Emmerich,145,Action,741969268
75000000,152368585,Kurt Russell,Ron Howard,137,Action,77368585
75000000,51142659,Harrison Ford,Ron Shelton,116,Action,-23857341
75000000,29000000,Steve Martin,Sam Weisman,90,Comedy,-46000000
75000000,224012234,Nicolas Cage,Simon West,115,Action,149012234
75000000,226904017,Mickey Rourke,Tarsem Singh,110,Fantasy,151904017
75000000,258270008,Angelina Jolie,Timur Bekmambetov,110,Action,183270008
75000000,180557550,Denzel Washington,Tony Scott,126,Action,105557550
76000000,69959751,Clive Owen,Alfonso Cuar√≥n,109,Drama,-6040249
76000000,35134820,Rene Russo,Des McAnuff,88,Adventure,-40865180
76000000,236350661,Paul Walker,John Singleton,107,Action,160350661
76000000,970761885,Steve Carell,Pierre Coffin,98,Animation,894761885
78000000,209196298,Anthony Hopkins,Brett Ratner,124,Crime,131196298
78000000,248384621,Bill Hader,Cody Cameron,95,Animation,170384621
78000000,179179718,Ben Affleck,Mark Steven Johnson,103,Fantasy,101179718
78000000,179265204,Sean Connery,Stephen Norrington,110,Fantasy,101265204
78146652,60000000,Clive Owen,Tony Gilroy,125,Thriller,-18146652
79000000,173013509,Jude Law,Anthony Minghella,154,Drama,94013509
79000000,355692760,Dwayne Johnson,Brad Peyton,94,Adventure,276692760
79000000,149673788,Adam Sandler,Dennis Dugan,91,Comedy,70673788
79000000,926287400,Elijah Wood,Peter Jackson,179,Adventure,847287400
80000000,212874442,Adam Sandler,Adam Shankman,99,Fantasy,132874442
80000000,157107755,Denzel Washington,Albert Hughes,118,Action,77107755
80000000,33463969,Val Kilmer,Antony Hoffman,106,Thriller,-46536031
80000000,457696359,Tom Cruise,Brian De Palma,110,Adventure,377696359
80000000,660940780,Ray Romano,Carlos Saldanha,91,Animation,580940780
80000000,116643346,Samuel L. Jackson,Clark Johnson,117,Action,36643346
80000000,178066569,Shia LaBeouf,D.J. Caruso,118,Mystery,98066569
80000000,145771527,Chris Sanders,Dean DeBlois,85,Animation,65771527
80000000,271430189,Adam Sandler,Dennis Dugan,102,Comedy,191430189
80000000,246984278,Adam Sandler,Dennis Dugan,100,Comedy,166984278
80000000,214918407,Jennifer Aniston,Dennis Dugan,117,Romance,134918407
80000000,201584141,Dan Aykroyd,Eric Brevig,80,Comedy,121584141
80000000,169852759,Kevin James,Frank Coraci,102,Comedy,89852759
80000000,466183544,Adam Sandler,Genndy Tartakovsky,89,Animation,386183544
80000000,176885658,Robert De Niro,Harold Ramis,103,Comedy,96885658
80000000,98376292,David Duchovny,Ivan Reitman,101,Action,18376292
80000000,55041367,Adam Sandler,James L. Brooks,130,Comedy,-24958633
80000000,91188905,Liam Neeson,Jan de Bont,113,Horror,11188905
80000000,516642939,Ben Stiller,Jay Roach,115,Comedy,436642939
80000000,68514844,Brendan Fraser,Joe Dante,90,Animation,-11485156
80000000,230000000,Michael Jordan,Joe Pytka,88,Animation,150000000
80000000,10166502,Benjamin Bratt,John Dahl,132,Action,-69833498
80000000,245676146,John Travolta,John Woo,138,Action,165676146
80000000,96105964,Denzel Washington,Jonathan Demme,129,Drama,16105964
80000000,122444772,Bruce Willis,Jonathan Mostow,89,Action,42444772
80000000,122563539,Matt Damon,Kelly Asbury,83,Western,42563539
80000000,17626234,Kevin Costner,Kevin Costner,177,Drama,-62373766
80000000,177977226,Robin Williams,Les Mayfield,93,Comedy,97977226
80000000,118880016,Kevin Costner,Luis Mandoki,131,Drama,38880016
80000000,74901339,Mel Gibson,Martin Campbell,117,Crime,-5098661
80000000,294804195,Leonardo DiCaprio,Martin Scorsese,138,Drama,214804195
80000000,214104620,Christian Bale,Michael Mann,140,History,134104620
80000000,266728738,Jack Nicholson,Nancy Meyers,128,Drama,186728738
80000000,126546518,Charlie Rowe,Neil Nightingale,87,Animation,46546518
80000000,15071514,Nicole Kidman,Oliver Hirschbiegel,99,Science Fiction,-64928486
80000000,5989640,Heike Makatsch,Peter Hyams,110,Thriller,-74010360
80000000,230685453,Steve Carell,Peter Segal,110,Action,150685453
80000000,78000586,Stellan Skarsg√•rd,Renny Harlin,114,Horror,-1999414
80000000,19480739,Paul Walker,Richard Donner,116,Action,-60519261
80000000,159212469,Sylvester Stallone,Rob Cohen,115,Action,79212469
80000000,53825515,Judi Dench,Rob Marshall,112,Drama,-26174485
80000000,39459427,Matt Damon,Robert Redford,126,Fantasy,-40540573
80000000,34566746,Kevin Costner,Roger Donaldson,145,Drama,-45433254
80000000,309492681,Mel Gibson,Ron Howard,117,Action,229492681
80000000,181001478,Tom Hanks,Sam Mendes,117,Thriller,101001478
80000000,233093859,Keanu Reeves,Scott Derrickson,103,Drama,153093859
80000000,163733697,Reese Witherspoon,Seth Gordon,88,Comedy,83733697
80000000,123729176,Guy Pearce,Simon Wells,96,Science Fiction,43729176
80000000,136159423,Gary Oldman,Stephen Hopkins,130,Adventure,56159423
80000000,415885488,Brendan Fraser,Stephen Sommers,124,Adventure,335885488
80000000,37384046,Kiefer Sutherland,Steve 'Spaz' Williams,94,Family,-42615954
80000000,162944923,Nicole Kidman,Sydney Pollack,128,Action,82944923
80000000,274470394,Sylvester Stallone,Sylvester Stallone,103,Action,194470394
80000000,73345029,Eddie Murphy,Ted Demme,108,Comedy,-6654971
80000000,280000000,Michael Keaton,Tim Burton,126,Action,200000000
80000000,155019340,Bruce Willis,Tim Johnson,83,Comedy,75019340
80000000,254455986,Bradley Cooper,Todd Phillips,102,Comedy,174455986
80000000,484572835,Jim Carrey,Tom Shadyac,101,Fantasy,404572835
80000000,140073390,Emily Barclay,Zack Snyder,97,Animation,60073390
81000000,403802136,Taron Egerton,Matthew Vaughn,130,Crime,322802136
82000000,47434430,Jim Carrey,Milo≈° Forman,118,Comedy,-34565570
82000000,190320568,Adam Sandler,Peter Segal,113,Comedy,108320568
82000000,96085477,Arnold Schwarzenegger,Roger Spottiswoode,123,Action,14085477
82000000,89792502,Emily Browning,Zack Snyder,110,Action,7792502
82500000,237681299,Adam Sandler,Frank Coraci,107,Comedy,155181299
83000000,59468275,Mark Addy,Brian Levant,90,Science Fiction,-23531725
84000000,123307945,Eddie Murphy,Peter Segal,106,Fantasy,39307945
84000000,275650703,Freddie Prinze Jr.,Raja Gosnell,88,Mystery,191650703
85000000,78382433,Arnold Schwarzenegger,Andrew Davis,108,Action,-6617567
85000000,149044513,Shia LaBeouf,Ash Brannon,85,Animation,64044513
85000000,112483764,James Marsden,Brad Peyton,82,Comedy,27483764
85000000,208076205,Denzel Washington,Daniel Espinosa,115,Action,123076205
85000000,186072214,Adam Sandler,Dennis Dugan,115,Comedy,101072214
85000000,222231186,Hayden Christensen,Doug Liman,88,Adventure,137231186
85000000,358375603,Adam Sandler,Genndy Tartakovsky,91,Animation,273375603
85000000,160388063,Ron Perlman,Guillermo del Toro,120,Adventure,75388063
85000000,297138014,Jim Carrey,Jimmy Hayward,88,Animation,212138014
85000000,137298489,Arnold Schwarzenegger,John McTiernan,130,Adventure,52298489
85000000,252712101,Tate Donovan,John Musker,93,Animation,167712101
85000000,158468292,Lucas Black,Justin Lin,104,Action,73468292
85000000,363164265,Vin Diesel,Justin Lin,107,Action,278164265
85000000,183611771,Glenn Close,Kevin Lima,100,Comedy,98611771
85000000,340487652,Patrick Dempsey,Kevin Lima,107,Comedy,255487652
85000000,194168700,Cameron Diaz,Nancy Meyers,136,Comedy,109168700
85000000,219103655,Meryl Streep,Nancy Meyers,121,Comedy,134103655
85000000,288747895,Shailene Woodley,Neil Burger,139,Action,203747895
85000000,131426169,Nicole Kidman,Nora Ephron,102,Comedy,46426169
85000000,80916492,Dwayne Johnson,Peter Berg,104,Adventure,-4083508
85000000,162242962,Zhang Ziyi,Rob Marshall,145,Drama,77242962
85000000,59908565,Matt Damon,Robert De Niro,167,Drama,-25091435
85000000,197309027,Martin Lawrence,Roger Allers,83,Adventure,112309027
85000000,450717150,George Clooney,Steven Soderbergh,116,Thriller,365717150
85000000,311312624,George Clooney,Steven Soderbergh,122,Crime,226312624
85000000,183018522,Julia Roberts,Tarsem Singh,106,Adventure,98018522
85000000,77741732,Robert De Niro,Tom Dey,95,Action,-7258268
85000000,71485043,Robin Williams,Vincent Ward,113,Drama,-13514957
85000000,315156409,Harrison Ford,Wolfgang Petersen,124,Action,230156409
86000000,14373825,Hayden Christensen,Joby Harold,84,Thriller,-71626175
87000000,148336445,Jeff Bridges,Gary Ross,141,Drama,61336445
87000000,71073932,Ice Cube,Lee Tamahori,101,Action,-15926068
87000000,351692268,Anthony Hopkins,Ridley Scott,131,Crime,264692268
88000000,243637091,Adam Sandler,Chris Columbus,105,Action,155637091
88000000,108539911,Russell Crowe,Ron Howard,144,Romance,20539911
88000000,105316267,Heath Ledger,Terry Gilliam,118,Adventure,17316267
90000000,140807547,Harrison Ford,Alan J. Pakula,107,Crime,50807547
90000000,16178959,Nathan Lane,Andrei Konchalovsky,110,Fantasy,-73821041
90000000,589390539,Tommy Lee Jones,Barry Sonnenfeld,98,Action,499390539
90000000,188133322,Ben Stiller,Ben Stiller,114,Adventure,98133322
90000000,140396650,Vin Diesel,Breck Eisner,106,Fantasy,50396650
90000000,347325802,Chris Tucker,Brett Ratner,90,Action,257325802
90000000,60874615,Gary Sinise,Brian De Palma,114,Science Fiction,-29125385
90000000,484635760,Jesse Eisenberg,Carlos Saldanha,96,Animation,394635760
90000000,886686817,Ray Romano,Carlos Saldanha,94,Animation,796686817
90000000,65900249,Ryan Phillippe,Clint Eastwood,132,War,-24099751
90000000,113493481,Sylvester Stallone,Danny Cannon,96,Science Fiction,23493481
90000000,232617430,Daniel Craig,David Fincher,158,Thriller,142617430
90000000,201596308,Adam Sandler,Dennis Dugan,113,Comedy,111596308
90000000,237202299,Nicolas Cage,Dominic Sena,118,Action,147202299
90000000,102000000,Nicole Kidman,Frank Oz,93,Action,12000000
90000000,69131860,James Cromwell,George Miller,92,Adventure,-20868140
90000000,524028679,Robert Downey Jr.,Guy Ritchie,128,Adventure,434028679
90000000,485015179,Tom Hanks,John Lasseter,92,Animation,395015179
90000000,366101666,Bruce Willis,John McTiernan,128,Action,276101666
90000000,263920180,Bruce Willis,Luc Besson,126,Adventure,173920180
90000000,48795021,Jason Momoa,Marcus Nispel,113,Adventure,-41204979
90000000,162839667,Freddie Highmore,Mark Waters,95,Adventure,72839667
90000000,142940100,Brad Pitt,Martin Brest,178,Fantasy,52940100
90000000,289847354,Leonardo DiCaprio,Martin Scorsese,151,Drama,199847354
90000000,60289912,Al Pacino,Michael Mann,157,Drama,-29710088
90000000,206172544,Sylvester Stallone,Patrick Hughes,127,Action,116172544
90000000,161626121,Mel Gibson,Paul Abascal,100,Drama,71626121
90000000,182290266,Eddie Murphy,Rob Minkoff,99,Thriller,92290266
90000000,171120329,Jodie Foster,Robert Zemeckis,150,Drama,81120329
90000000,429632142,Tom Hanks,Robert Zemeckis,143,Adventure,339632142
90000000,174578751,Logan Lerman,Thor Freudenthal,106,Adventure,84578751
90000000,304320254,Ming-Na Wen,Tony Bancroft,88,Animation,214320254
90000000,250649836,Will Smith,Tony Scott,132,Action,160649836
90000000,14828081,James Spader,Walter Hill,91,Science Fiction,-75171919
92000000,188072649,Ben Stiller,Ben Stiller,107,Action,96072649
92000000,631442092,Craig T. Nelson,Brad Bird,115,Action,539442092
92000000,494471524,Helen Hunt,Jan de Bont,113,Action,402471524
92000000,304654182,Bruce Willis,John Moore,98,Action,212654182
92000000,264105545,Cameron Diaz,McG,98,Action,172105545
92000000,172989651,Josh Hartnett,Ridley Scott,144,Action,80989651
92000000,143049560,Robert Redford,Tony Scott,126,Action,51049560
93000000,368780809,Sam Neill,Joe Johnston,92,Adventure,275780809
93000000,871368364,Elijah Wood,Peter Jackson,178,Adventure,778368364
93000000,482860185,Andy Serkis,Rupert Wyatt,105,Thriller,389860185
94000000,864625978,Albert Brooks,Andrew Stanton,100,Animation,770625978
94000000,1118888979,Elijah Wood,Peter Jackson,201,Adventure,1024888979
94000000,54744738,Kip Pardue,Renny Harlin,116,Action,-39255262
95000000,226497209,Logan Lerman,Chris Columbus,118,Adventure,131497209
95000000,76432727,Kenneth Branagh,Don Michael Paul,89,Adventure,-18567273
95000000,156505388,Angelina Jolie,Jan de Bont,117,Action,61505388
95000000,542351353,Lily James,Kenneth Branagh,112,Romance,447351353
95000000,250288523,Antonio Banderas,Martin Campbell,136,Adventure,155288523
95000000,190213455,Elisabeth Shue,Paul Verhoeven,112,Action,95213455
95000000,114178613,Jeff Bridges,Sergey Bodrov,102,Adventure,19178613
95000000,877244782,John Leguizamo,Steve Martino,88,Animation,782244782
98000000,18517322,Geena Davis,Renny Harlin,119,Action,-79482678
98000000,433013274,Brendan Fraser,Stephen Sommers,130,Action,335013274
99000000,246233113,Noah Schnapp,Steve Martino,88,Adventure,147233113
100000000,170432927,Will Ferrell,Adam McKay,107,Action,70432927
100000000,68688831,Will Ferrell,Brad Silberling,102,Adventure,-31311169
100000000,243400000,Dwayne Johnson,Brett Ratner,99,Action,143400000
100000000,876688482,Daniel Radcliffe,Chris Columbus,161,Adventure,776688482
100000000,93700000,Robin Williams,Chris Columbus,131,Comedy,-6300000
100000000,268426634,Josh Hutcherson,Chris Wedge,102,Animation,168426634
100000000,242295562,Arnold Schwarzenegger,Chuck Russell,115,Action,142295562
100000000,97838349,Vince Vaughn,David Dobkin,116,Action,-2161651
100000000,202026112,Jim Carrey,Dean Parisot,90,Comedy,102026112
100000000,170877916,Leonardo DiCaprio,Edward Zwick,143,Drama,70877916
100000000,278346189,Johnny Depp,Florian Henckel von Donnersmarck,103,Action,178346189
100000000,230427240,Keanu Reeves,Francis Lawrence,121,Drama,130427240
100000000,100138851,Tom Hulce,Gary Trousdale,91,Family,138851
100000000,384335608,Lombardo Boyar,George Miller,108,Music,284335608
100000000,520000000,Arnold Schwarzenegger,James Cameron,137,Action,420000000
100000000,108103450,Viggo Mortensen,Joe Johnston,136,Western,8103450
100000000,336529144,Val Kilmer,Joel Schumacher,121,Science Fiction,236529144
100000000,347451894,Nicolas Cage,Jon Turteltaub,131,Adventure,247451894
100000000,35168966,Harrison Ford,Kathryn Bigelow,138,Thriller,-64831034
100000000,169327687,David Spade,Mark Dindal,78,Adventure,69327687
100000000,193772504,Leonardo DiCaprio,Martin Scorsese,167,Drama,93772504
100000000,392000694,Leonardo DiCaprio,Martin Scorsese,180,Crime,292000694
100000000,288347692,Sarah Jessica Parker,Michael Patrick King,146,Comedy,188347692
100000000,121975011,Jeremy Sumpter,P.J. Hogan,113,Adventure,21975011
100000000,94882889,Matt Damon,Paul Greengrass,115,Action,-5117111
100000000,310650585,Robert De Niro,Paul Weitz,98,Comedy,210650585
100000000,211989043,Arnold Schwarzenegger,Peter Hyams,121,Action,111989043
100000000,242988466,Bill Hader,Phil Lord,90,Animation,142988466
100000000,82102379,Halle Berry,Pitof,104,Action,-17897621
100000000,425368238,Jamie Foxx,Quentin Tarantino,165,Drama,325368238
100000000,266465037,Denzel Washington,Ridley Scott,157,Drama,166465037
100000000,155464351,Harrison Ford,Robert Zemeckis,130,Drama,55464351
100000000,93820758,Chris Hemsworth,Ron Howard,122,Thriller,-6179242
100000000,7103973,Eddie Murphy,Ron Underwood,95,Action,-92896027
100000000,312573423,Sylvester Stallone,Simon West,103,Action,212573423
100000000,100086793,Max Records,Spike Jonze,101,Family,86793
100000000,249288105,Ed Speleers,Stefen Fangmeier,104,Fantasy,149288105
100000000,235926552,Haley Joel Osment,Steven Spielberg,146,Drama,135926552
100000000,206071502,Johnny Depp,Tim Burton,105,Drama,106071502
100000000,362211740,Mark Wahlberg,Tim Burton,119,Thriller,262211740
100000000,330579719,Ioan Gruffudd,Tim Story,106,Action,230579719
100000000,150166126,Denzel Washington,Tony Scott,106,Thriller,50166126
100000000,167805466,Denzel Washington,Tony Scott,98,Action,67805466
100000000,103039258,Johnny Depp,Wally Pfister,119,Thriller,3039258
102000000,147080413,John Travolta,Dominic Sena,99,Action,45080413
102000000,130482868,Tom Hanks,Lilly Wachowski,172,Drama,28482868
102000000,358372926,Tom Cruise,Steven Spielberg,145,Action,256372926
103000000,500188435,Jesse Eisenberg,Carlos Saldanha,102,Animation,397188435
103000000,457640427,Russell Crowe,Ridley Scott,155,Action,354640427
103000000,362000072,Bradley Cooper,Todd Phillips,100,Comedy,259000072
105000000,716392705,Sandra Bullock,Alfonso Cuar√≥n,91,Science Fiction,611392705
105000000,351040419,Leonardo DiCaprio,Baz Luhrmann,143,Drama,246040419
105000000,115772733,Vin Diesel,David Twohy,119,Adventure,10772733
105000000,133718711,Edgar Ram√≠rez,Ericson Core,114,Action,28718711
105000000,121214377,Casper Van Dien,Paul Verhoeven,129,Adventure,16214377
105000000,347434178,Neil Patrick Harris,Raja Gosnell,105,Fantasy,242434178
105000000,266000000,Steven Strait,Roland Emmerich,109,Adventure,161000000
105000000,267045765,Anika Noni Rose,Ron Clements,97,Romance,162045765
107000000,87713825,Will Smith,Michael Mann,157,Drama,-19286175
108000000,595380321,Matt Damon,Ridley Scott,141,Drama,487380321
110000000,712171856,Kristen Stewart,Bill Condon,117,Adventure,602171856
110000000,470490832,Dwayne Johnson,Brad Peyton,114,Action,360490832
110000000,214948780,Patrick Stewart,Bryan Singer,133,Adventure,104948780
110000000,478207520,Angelina Jolie,Doug Liman,120,Action,368207520
110000000,72178895,Jackie Chan,Frank Coraci,120,Action,-37821105
110000000,125537191,Asa Butterfield,Gavin Hood,114,Science Fiction,15537191
110000000,177238796,Liam Neeson,Joe Carnahan,117,Thriller,67238796
110000000,383531464,Bruce Willis,Len Wiseman,128,Action,273531464
110000000,228738393,Nicolas Cage,Mark Steven Johnson,114,Thriller,118738393
110000000,337580051,Sullivan Stapleton,Noam Murro,102,Action,227580051
110000000,293329073,Angelina Jolie,Phillip Noyce,100,Action,183329073
110000000,563749323,Neil Patrick Harris,Raja Gosnell,103,Animation,453749323
110000000,295238201,Shailene Woodley,Robert Schwentke,119,Adventure,185238201
110000000,333011068,Pierce Brosnan,Roger Spottiswoode,119,Adventure,223011068
110000000,215294342,Mel Gibson,Roland Emmerich,165,Drama,105294342
110000000,574480841,Ben Stiller,Shawn Levy,108,Action,464480841
110000000,299268508,Hugh Jackman,Shawn Levy,127,Action,189268508
110000000,362744280,George Clooney,Steven Soderbergh,125,Thriller,252744280
110000000,103951461,Randy Quaid,Will Finn,76,Western,-6048539
112000000,237382724,Emily Blunt,Rob Letterman,85,Comedy,125382724
113000000,850000000,Ewan McGregor,George Lucas,140,Science Fiction,737000000
115000000,924317558,Liam Neeson,George Lucas,136,Adventure,809317558
115000000,378882411,Arnold Schwarzenegger,James Cameron,141,Action,263882411
115000000,77628265,Nicolas Cage,John Woo,134,Drama,-37371735
115000000,562816256,John Goodman,Lee Unkrich,92,Fantasy,447816256
115000000,286140700,Matt Damon,Neill Blomkamp,109,Science Fiction,171140700
115000000,274703340,Angelina Jolie,Simon West,100,Adventure,159703340
116000000,102000000,Leonardo DiCaprio,Martin Scorsese,170,Drama,-14000000
116000000,178127760,Pierce Brosnan,Roger Donaldson,108,Action,62127760
117000000,261930431,Tom Cruise,James Mangold,109,Action,144930431
120000000,347234916,Will Smith,Alex Proyas,115,Action,227234916
120000000,609016565,Suraj Sharma,Ang Lee,127,Adventure,489016565
120000000,203567857,Clive Owen,Antoine Fuqua,126,Adventure,83567857
120000000,829000000,Kristen Stewart,Bill Condon,115,Adventure,709000000
120000000,186053725,Michael J. Fox,Gary Trousdale,95,Animation,66053725
120000000,649398328,Ewan McGregor,George Lucas,142,Adventure,529398328
120000000,48668907,Reese Witherspoon,James L. Brooks,121,Comedy,-71331093
120000000,415440673,Hugh Jackman,James Mangold,126,Action,295440673
120000000,363398565,Kevin Spacey,John Lasseter,95,Family,243398565
120000000,461983149,Owen Wilson,John Lasseter,117,Animation,341983149
120000000,239379423,Joel Kinnaman,Jos√© Padilha,102,Science Fiction,119379423
120000000,286168572,Tom Cruise,Joseph Kosinski,126,Action,166168572
120000000,93945766,Emile Hirsch,Lana Wachowski,135,Family,-26054234
120000000,259175788,Cameron Diaz,McG,106,Action,139175788
120000000,227817248,Seth Rogen,Michel Gondry,119,Action,107817248
120000000,169956806,Michael J. Fox,Rob Minkoff,78,Family,49956806
120000000,325756637,George Clooney,Wolfgang Petersen,130,Drama,205756637
120000001,167977596,Miles Teller,Josh Trank,100,Action,47977595
123000000,345141403,Jim Carrey,Ron Howard,104,Family,222141403
125000000,976475550,Daniel Radcliffe,Chris Columbus,152,Adventure,851475550
125000000,362637473,Russell Crowe,Darren Aronofsky,139,Drama,237637473
125000000,1327817822,Daniel Radcliffe,David Yates,130,Adventure,1202817822
125000000,752100229,Jennifer Lawrence,Francis Lawrence,123,Science Fiction,627100229
125000000,334615000,Robert Downey Jr.,Guy Ritchie,129,Adventure,209615000
125000000,238207122,Arnold Schwarzenegger,Joel Schumacher,125,Action,113207122
125000000,546388105,Tom Cruise,John Woo,123,Adventure,421388105
125000000,477200000,Megan Fox,Jonathan Liebesman,101,Science Fiction,352200000
125000000,626137675,Vin Diesel,Justin Lin,130,Action,501137675
125000000,198802074,Colin Farrell,Len Wiseman,121,Action,73802074
125000000,232713139,Sam Worthington,Louis Leterrier,106,Adventure,107713139
125000000,544272402,Dennis Quaid,Roland Emmerich,124,Action,419272402
125000000,758239851,Tom Hanks,Ron Howard,149,Thriller,633239851
126000000,162949164,Ewan McGregor,Michael Bay,136,Action,36949164
127000000,349424282,Ben Stiller,Shawn Levy,97,Adventure,222424282
127500000,354248063,D. B. Sweeney,Ralph Zondag,82,Animation,226748063
130000000,789804554,Daniel Radcliffe,Alfonso Cuar√≥n,141,Adventure,659804554
130000000,49554002,Nicole Kidman,Baz Luhrmann,165,Drama,-80445998
130000000,119269486,Matthew McConaughey,Breck Eisner,124,Action,-10730514
130000000,554987477,Antonio Banderas,Chris Miller,90,Action,424987477
130000000,847423452,Jennifer Lawrence,Francis Lawrence,146,Science Fiction,717423452
130000000,150406466,Elijah Wood,George Miller,100,Music,20406466
130000000,371876278,Dwayne Johnson,Jon M. Chu,110,Adventure,241876278
130000000,457363168,Nicolas Cage,Jon Turteltaub,124,Action,327363168
130000000,243843127,Jaden Smith,M. Night Shyamalan,100,Science Fiction,113843127
130000000,631744560,Jack Black,Mark Osborne,90,Animation,501744560
130000000,273339556,Martin Lawrence,Michael Bay,147,Adventure,143339556
130000000,117831631,Kit Harington,Paul W.S. Anderson,105,Action,-12168369
130000000,518602163,Paul Rudd,Peyton Reed,115,Science Fiction,388602163
130000000,403170142,Noomi Rapace,Ridley Scott,124,Science Fiction,273170142
130000000,211643158,Orlando Bloom,Ridley Scott,144,Drama,81643158
130000000,61648500,Jeff Bridges,Robert Schwentke,96,Fantasy,-68351500
130000000,379014294,Matthew Broderick,Roland Emmerich,139,Science Fiction,249014294
130000000,371940071,Jamie Bell,Steven Spielberg,107,Adventure,241940071
130000000,289047763,Ioan Gruffudd,Tim Story,92,Adventure,159047763
130000000,321885765,Will Ferrell,Tom McGrath,95,Animation,191885765
130000000,276572938,Jeremy Renner,Tony Gilroy,120,Action,146572938
130000000,185258983,Malin kerman,Zack Snyder,162,Action,55258983
132000000,373552094,Tom McGrath,Simon J. Smith,92,Family,241552094
132000000,591739379,Tom Cruise,Steven Spielberg,116,Adventure,459739379
133000000,300135367,Michael J. Fox,Rob Minkoff,84,Fantasy,167135367
135000000,532950503,Leonardo DiCaprio,Alejandro Gonz√°lez I√±√°rritu,156,Western,397950503
135000000,282570682,Ryan Reynolds,David Soren,96,Animation,147570682
135000000,245724603,Johnny Depp,Gore Verbinski,107,Animation,110724603
135000000,585178928,Nicolas Cage,Kirk De Micco,98,Adventure,450178928
135000000,361832400,Pierce Brosnan,Michael Apted,128,Adventure,226832400
135000000,163794509,Jamie Foxx,Michael Mann,134,Action,28794509
135000000,76932943,Josh Lucas,Rob Cohen,121,Action,-58067057
135000000,368871007,Jim Parsons,Tim Johnson,94,Fantasy,233871007
137000000,245360480,Eric Bana,Ang Lee,138,Action,108360480
137000000,85131830,Donald Sutherland,Hironobu Sakaguchi,106,Adventure,-51868170
139000000,821708551,Tobey Maguire,Sam Raimi,121,Fantasy,682708551
140000000,441818803,Tommy Lee Jones,Barry Sonnenfeld,88,Action,301818803
140000000,209073645,Jim Carrey,Brad Silberling,108,Adventure,69073645
140000000,258022233,Chris Tucker,Brett Ratner,91,Action,118022233
140000000,456758981,Tom Cruise,Edward Zwick,154,Drama,316758981
140000000,655011224,Johnny Depp,Gore Verbinski,143,Adventure,515011224
140000000,370569774,Chris Evans,Joe Johnston,124,Action,230569774
140000000,585174222,Robert Downey Jr.,Jon Favreau,126,Action,445174222
140000000,431971116,Pierce Brosnan,Lee Tamahori,133,Adventure,291971116
140000000,449220945,Ben Affleck,Michael Bay,183,History,309220945
140000000,553799566,Bruce Willis,Michael Bay,151,Action,413799566
140000000,285444603,Mel Gibson,Richard Donner,127,Action,145444603
140000000,268031828,Christian Bale,Ridley Scott,153,Adventure,128031828
140000000,109578115,Joseph Gordon-Levitt,Ron Clements,95,Adventure,-30421885
145000000,694713380,Tom Cruise,Brad Bird,133,Action,549713380
145000000,609123048,Jay Baruchel,Dean DeBlois,102,Fantasy,464123048
145000000,746921274,Ben Stiller,Eric Darnell,93,Animation,601921274
145000000,25819961,Dennis Quaid,John Lee Hancock,137,Western,-119180039
145000000,306941670,Chris Pine,Peter Ramsey,97,Fantasy,161941670
145000000,401128639,Brendan Fraser,Rob Cohen,112,Adventure,256128639
145000000,272912430,Ty Burrell,Rob Minkoff,92,Animation,127912430
149000000,64459316,Hugh Jackman,David Bowers,85,Adventure,-84540684
150000000,919838758,Mike Myers,Andrew Adamson,93,Adventure,769838758
150000000,623722818,Patton Oswalt,Brad Bird,111,Animation,473722818
150000000,1274219009,Kristen Bell,Chris Buck,102,Animation,1124219009
150000000,309979994,John Travolta,Chris Williams,96,Animation,159979994
150000000,682330139,Tom Cruise,Christopher McQuarrie,131,Action,532330139
150000000,374218673,Christian Bale,Christopher Nolan,140,Action,224218673
150000000,1513528810,Chris Pratt,Colin Trevorrow,124,Action,1363528810
150000000,333932083,Cate Blanchett,David Fincher,166,Fantasy,183932083
150000000,938212738,Daniel Radcliffe,David Yates,138,Adventure,788212738
150000000,603900354,Ben Stiller,Eric Darnell,89,Family,453900354
150000000,585349010,Will Smith,Francis Lawrence,101,Drama,435349010
150000000,341131793,Hugh Jackman,Gavin Hood,107,Adventure,191131793
150000000,378436354,Tom Hardy,George Miller,120,Action,228436354
150000000,292817841,Sam Rockwell,Hoyt Yeatman,88,Fantasy,142817841
150000000,385680446,Chris Pine,J.J. Abrams,127,Science Fiction,235680446
150000000,397850012,Tom Cruise,J.J. Abrams,126,Adventure,247850012
150000000,665692281,Jack Black,Jennifer Yuh,91,Animation,515692281
150000000,128388320,Levi Miller,Joe Wright,111,Adventure,-21611680
150000000,215283742,Nicolas Cage,Jon Turteltaub,109,Fantasy,65283742
150000000,301000000,Sam Worthington,Jonathan Liebesman,99,Adventure,151000000
150000000,444115007,Chris Hemsworth,Kenneth Branagh,115,Adventure,294115007
150000000,738599701,Keanu Reeves,Lilly Wachowski,138,Adventure,588599701
150000000,424988211,Keanu Reeves,Lilly Wachowski,129,Adventure,274988211
150000000,163712074,Edward Norton,Louis Leterrier,114,Science Fiction,13712074
150000000,318502923,Noah Ringer,M. Night Shyamalan,103,Action,168502923
150000000,314432665,Zach Braff,Mark Dindal,81,Animation,164432665
150000000,599045960,Daniel Craig,Martin Campbell,144,Adventure,449045960
150000000,709709780,Shia LaBeouf,Michael Bay,144,Adventure,559709780
150000000,836297228,Shia LaBeouf,Michael Bay,150,Science Fiction,686297228
150000000,895921036,Daniel Radcliffe,Mike Newell,157,Adventure,745921036
150000000,335154643,Jake Gyllenhaal,Mike Newell,116,Adventure,185154643
150000000,624029371,Will Smith,Peter Berg,92,Fantasy,474029371
150000000,212011111,Russell Crowe,Peter Weir,138,Adventure,62011111
150000000,205366737,Channing Tatum,Roland Emmerich,131,Action,55366737
150000000,356613439,Tom Hanks,Ron Howard,138,Thriller,206613439
150000000,413106170,Ben Stiller,Shawn Levy,105,Adventure,263106170
150000000,38992758,Seth Green,Simon Wells,88,Adventure,-111007242
150000000,169332978,Tom Selleck,Stephen J. Anderson,95,Animation,19332978
150000000,287594577,Jerry Seinfeld,Steve Hickner,91,Family,137594577
150000000,474968763,Johnny Depp,Tim Burton,115,Adventure,324968763
150000000,245527149,Johnny Depp,Tim Burton,113,Comedy,95527149
155000000,440603537,Arnold Schwarzenegger,Alan Taylor,125,Science Fiction,285603537
155000000,415686217,Skandar Keynes,Michael Apted,113,Adventure,260686217
155000000,167298192,Colin Farrell,Oliver Stone,175,War,12298192
160000000,798958165,Mike Myers,Chris Miller,93,Fantasy,638958165
160000000,825500000,Leonardo DiCaprio,Christopher Nolan,148,Action,665500000
160000000,650523427,Jennifer Lawrence,Francis Lawrence,136,War,490523427
160000000,529076069,Aaron Taylor-Johnson,Gareth Edwards,123,Action,369076069
160000000,164508066,Sandra Bullock,Jan de Bont,121,Action,4508066
160000000,61698899,Antonio Banderas,John McTiernan,102,Adventure,-98301101
160000000,788679850,Paul Walker,Justin Lin,130,Action,628679850
160000000,344420111,James McAvoy,Matthew Vaughn,132,Action,184420111
160000000,300257475,Hugh Jackman,Stephen Sommers,132,Horror,140257475
160000000,181674817,Kurt Russell,Wolfgang Petersen,99,Adventure,21674817
163000000,174822325,Daniel Craig,Jon Favreau,119,Action,11822325
165000000,621752480,Matthew McConaughey,Christopher Nolan,169,Adventure,456752480
165000000,494878759,Jay Baruchel,Dean DeBlois,98,Fantasy,329878759
165000000,652105443,Scott Adsit,Don Hall,102,Adventure,487105443
165000000,752600867,Mike Myers,Mike Mitchell,93,Comedy,587600867
165000000,471222889,John C. Reilly,Rich Moore,108,Family,306222889
165000000,305875730,Tom Hanks,Robert Zemeckis,100,Animation,140875730
170000000,479765000,Chris Hemsworth,Alan Taylor,112,Action,309765000
170000000,222104681,Will Smith,Barry Sonnenfeld,106,Action,52104681
170000000,773312399,Chris Pratt,James Gunn,121,Action,603312399
170000000,714766572,Chris Evans,Joe Russo,136,Action,544766572
170000000,400062763,Garrett Hedlund,Joseph Kosinski,125,Adventure,230062763
170000000,185770160,Asa Butterfield,Martin Scorsese,126,Adventure,15770160
170000000,708200000,Andy Serkis,Matt Reeves,130,Science Fiction,538200000
170000000,396600000,Kristen Stewart,Rupert Sanders,127,Adventure,226600000
175000000,731342744,Ed Asner,Bob Peterson,96,Animation,556342744
175000000,150962475,Keanu Reeves,Carl Rinsch,118,Action,-24037525
175000000,264218220,Kevin Costner,Kevin Reynolds,135,Adventure,89218220
175000000,853708609,Amy Poehler,Pete Docter,94,Comedy,678708609
175000000,331926147,Raymond Ochoa,Peter Sohn,93,Adventure,156926147
175000000,381509870,Seth Rogen,Rob Letterman,94,Animation,206509870
175000000,302469017,Dennis Quaid,Stephen Sommers,118,Adventure,127469017
175000000,173000000,Steve Carell,Tom Shadyac,96,Fantasy,-2000000
175000000,497409852,Brad Pitt,Wolfgang Petersen,163,War,322409852
176000003,183987723,Mila Kunis,Lana Wachowski,124,Science Fiction,7987720
178000000,370541256,Tom Cruise,Doug Liman,113,Action,192541256
180000000,748806957,William Moseley,Andrew Adamson,143,Adventure,568806957
180000000,521311860,Ben Burtt,Andrew Stanton,98,Animation,341311860
180000000,372234864,Nicole Kidman,Chris Weitz,113,Adventure,192234864
180000000,407602906,Idris Elba,Guillermo del Toro,131,Action,227602906
180000000,758410378,Angelina Jolie,Robert Stromberg,97,Fantasy,578410378
185000000,1001921825,Christian Bale,Christopher Nolan,152,Drama,816921825
185000000,538983207,Kelly Macdonald,Mark Andrews,93,Animation,353983207
185000000,786636033,Harrison Ford,Steven Spielberg,122,Adventure,601636033
190000000,209035668,Britt Robertson,Brad Bird,130,Action,19035668
190000000,467365246,Chris Pine,J.J. Abrams,132,Action,277365246
190000000,1506249360,Vin Diesel,James Wan,137,Action,1316249360
195000000,197687603,Nicholas Hoult,Bryan Singer,114,Action,2687603
195000000,1123746996,Shia LaBeouf,Michael Bay,154,Action,928746996
200000000,743559607,Billy Crystal,Dan Scanlon,104,Animation,543559607
200000000,1065659812,Johnny Depp,Gore Verbinski,151,Adventure,865659812
200000000,2068178225,Harrison Ford,J.J. Abrams,136,Action,1868178225
200000000,1845034188,Kate Winslet,James Cameron,194,Drama,1645034188
200000000,559852396,Larry the Cable Guy,John Lasseter,106,Animation,359852396
200000000,623933331,Robert Downey Jr.,Jon Favreau,124,Adventure,423933331
200000000,435000000,Arnold Schwarzenegger,Jonathan Mostow,109,Action,235000000
200000000,1063171911,Tom Hanks,Lee Unkrich,103,Animation,863171911
200000000,531865000,Brad Pitt,Marc Forster,116,Action,331865000
200000000,586090727,Daniel Craig,Marc Forster,106,Adventure,386090727
200000000,705717432,Andrew Garfield,Marc Webb,142,Action,505717432
200000000,219851172,Ryan Reynolds,Martin Campbell,114,Adventure,19851172
200000000,371353001,Christian Bale,McG,115,Drama,171353001
200000000,310669540,Russell Crowe,Ridley Scott,140,Action,110669540
200000000,325233863,Gary Oldman,Robert Zemeckis,96,Animation,125233863
200000000,769653595,John Cusack,Roland Emmerich,158,Action,569653595
200000000,1108561013,Daniel Craig,Sam Mendes,143,Action,908561013
200000000,491868548,James Franco,Sam Raimi,130,Fantasy,291868548
200000000,783766341,Tobey Maguire,Sam Raimi,127,Action,583766341
200000000,1215439994,Robert Downey Jr.,Shane Black,130,Action,1015439994
200000000,1025467110,Mia Wasikowska,Tim Burton,108,Family,825467110
207000000,550000000,Naomi Watts,Peter Jackson,187,Adventure,343000000
209000000,303025485,Taylor Kitsch,Peter Berg,131,Thriller,94025485
210000000,234360014,Hugh Jackman,Brett Ratner,104,Adventure,24360014
210000000,245500000,Mark Wahlberg,Michael Bay,165,Science Fiction,35500000
215000000,752215857,Andrew Garfield,Marc Webb,136,Action,537215857
220000000,1519557910,Robert Downey Jr.,Joss Whedon,143,Science Fiction,1299557910
225000000,419651413,Ben Barnes,Andrew Adamson,150,Adventure,194651413
225000000,624026776,Will Smith,Barry Sonnenfeld,106,Action,399026776
225000000,662845518,Henry Cavill,Zack Snyder,143,Action,437845518
237000000,2781505847,Sam Worthington,James Cameron,162,Action,2544505847
245000000,880674609,Daniel Craig,Sam Mendes,148,Action,635674609
250000000,746000000,Hugh Jackman,Bryan Singer,131,Action,496000000
250000000,1081041287,Christian Bale,Christopher Nolan,165,Action,831041287
250000000,933959197,Daniel Radcliffe,David Yates,153,Adventure,683959197
250000000,954305868,Daniel Radcliffe,David Yates,146,Adventure,704305868
250000000,1017003568,Ian McKellen,Peter Jackson,169,Adventure,767003568
250000000,958400000,Martin Freeman,Peter Jackson,161,Adventure,708400000
250000000,955119788,Martin Freeman,Peter Jackson,144,Adventure,705119788
255000000,89289910,Johnny Depp,Gore Verbinski,149,Action,-165710090
258000000,890871626,Tobey Maguire,Sam Raimi,139,Fantasy,632871626
260000000,284139100,Taylor Kitsch,Andrew Stanton,132,Action,24139100
260000000,591794936,Zachary Levi,Nathan Greno,100,Animation,331794936
270000000,391081192,Brandon Routh,Bryan Singer,154,Adventure,121081192
280000000,1405035767,Robert Downey Jr.,Joss Whedon,141,Action,1125035767
300000000,961000000,Johnny Depp,Gore Verbinski,169,Adventure,661000000
380000000,1021683000,Johnny Depp,Rob Marshall,136,Adventure,641683000
425000000,11087569,Kate Bosworth,Sngmoo Lee,100,Adventure,-413912431